abasement	NN
abatement	NN
abduct	NN
abolition	NN
aborigines	NNS
abort	VB
abrade	VB
absorption	NN
abstinence	NN
abstain	NN
accrual	NN
acerbic	JJ
acquit	VB
adamancy	NN
addled	JJ
aesthete	NN
affectation	NN
aggregation	NN
allegation	NN
allegorical	JJ
altruism	NN
ambiguity	NN
ambivalent	JJ
anachronism	NN
anarchy	NN
anathematize	VB
ancestral	JJ
anesthesia	NN
antagonistic	JJ
anthologize	NN
anthropocentrism	NN
anthropomorphism	NN
anticlimactic	JJ
apathetic	JJ
aphoristic	JJ
apostasy	NN
appraisal	NN
ardor	NN
aspiration	NN
assiduity	NN
assure	VB
audacity	NN
augur	VB
autonomy	NN
bated	JJ
bedraggled	VBN
belligerence	NN
benignity	NN
bequest	NN
bias	NN
blasphemous	JJ
bombast	NN
boom	NN
callus	NN
candid	JJ
causality	NN
celebrity	NN
celibacy	NN
cease	VB
chastity	NN
chauvinistic	JJ
circuit	NN
clairvoyance	NN
climax	NN
cloy	NN
coerce	NN
compatibility	NN
complacent	JJ
conciliate	VB
corrosion	NN
corrode	NN
COSMOS	NNP
decorous	JJ
defamation	NN
defy	VB
degrade	VB
demolish	VB
denote	VB
denunciation	NN
derision	NN
detriment	NN
discreet	NN
disputant	NN
disquietude	NN
dissuasion	NN
distortion	NN
divergence	NN
diversity	NN
divert	VB
docility	NN
ebullience	NN
eclecticism	NN
ecstatic	JJ
effervesce	NN
efficacious	JJ
effusion	NN
elation	NN
eloquent	JJ
embroidery	NN
empathize	VB
endorsement	NN
epicurean	NN
euphoric	JJ
evanescence	NN
evade	VB
exaction	NN
exegetical	JJ
expediency	NN
exploitative	JJ
exposition	NN
extrapolate	VB
exudation	NN
fallacy	NN
farcical	JJ
fatalistic	JJ
fawn	NN
felicity	NN
flabbergast	NN
flagging	JJ
foppish	JJ
forenSiCS	NN
frivolity	NN
frugal	JJ
futility	NN
garrulity	NN
gluttonous	JJ
grave	NN
heretic	NN
heterogenity	NN
hinder	VB
hulk	NN
hypocrisy	NN
hypotheSiS	NN
idiosyncratic	JJ
imperturbability	NN
inaugural	JJ
incoherence	NN
incompatibility	NN
incongruity	NN
incredulity	NN
indent	JJ
indictment	NN
indiscreet	NN
inefficacy	NN
inertia	NN
inference	NN
infuse	VB
ingenuity	NN
iniquity	NN
innovate	VB
insolent	JJ
insolvency	NN
insular	JJ
intimate	JJ
intricacy	NN
intuitive	JJ
invade	VB
inveigh	NN
irk	VB
jeopardy	NN
jingoism	NN
jubilant	JJ
knavery	NN
labyrinthine	NN
lamentation	NN
lecherous	JJ
liberate	VB
magnanimity	NN
malice	NN
malinger	NN
mar	FW
membranous	JJ
metamorphose	NN
migrate	VB
mobility	NN
mockery	NN
nihilism	NN
nostalgic	JJ
notorious	JJ
novel	JJ
obscurity	NN
obstinacy	NN
obtrusive	JJ
opulent	JJ
ordain	NN
orthodoxy	NN
ostentation	NN
ostracism	NN
palliative	NN
panorama	NN
pedantry	NN
perfidy	NN
perspicacity	NN
perturbation	NN
perusal	NN
Pious	JJ
piety	NN
piquancy	NN
plauditory	NN
poignant	JJ
polarization	NN
POMPOUS	JJ
potency	NN
precocity	NN
preemptive	JJ
profundity	NN
proletariat	NN
proliferate	VB
prolix	JJ
prophesy	NN
provocation	NN
provocative	JJ
prudence	NN
pugnacious	JJ
putrescence	NN
quiescence	NN
rapacity	NN
rarefy	NN
reap	VB
recede	VB
reciprocity	NN
reclusive	NN
redundancy	NN
refutation	NN
relentless	JJ
relevancy	NN
remonstrate	VB
remuneration	NN
renowned	VBN
reproachful	JJ
residual	JJ
resignation	NN
resilience	NN
resolute	JJ
resume	VB
resurgence	NN
retaliate	VB
reticent	JJ
retrenchment	NN
revere	NN
rueful	JJ
sagacity	NN
scavenger	NN
secede	VB
seclude	VB
seepage	NN
severance	NN
solemn	JJ
spontaneous	JJ
striate	NN
stupefaction	NN
subtle	JJ
suppose	VB
symbiotic	JJ
synopSiS	NN
synthesize	VB
tedium	NN
terminate	VB
torpid	NN
torrential	JJ
transcription	NN
transience	NN
transitoriness	NN
treacle	NN
truculent	JJ
unanimous	JJ
vacillation	NN
vagrancy	NN
vehemence	NN
vigorOUS	NN
vilification	NN
virtuosity	NN
wag	NN
whimsy	NN
zealous	JJ
diagnostic	JJ
discrimination	NN
dispersion	NN
divestiture	NN
eclectism	NN
elefiacal	JJ
elude	VB
epistle	NN
erosion	NN
estrangement	NN
euphony	NN
excision	NN
execution	NN
exhortation	NN
abase	VB
abash	NN
abate	NN
abbreviate	VB
abdicate	VB
abduction	NN
aberrant	JJ
abet	VB
abeyance	NN
abhor	NN
abhorrence	NN
abject	NN
abjure	VB
abjuration	NN
ablution	NN
abnegation	NN
abolish	VB
abloition	NN
abominable	JJ
aboriginal	NN
abortive	JJ
abrasive	JJ
abridge	VB
abrogate	VBP
abscond	VB
absolute	JJ
absolve	VB
absolution	NN
absorb	VB
abstemious	JJ
abstract	JJ
abstruse	NN
abundant	JJ
abusive	JJ
abut	NN
abysmal	JJ
abyss	NN
academic	JJ
accede	VB
accelerate	VB
accentuate	NN
accessible	JJ
accessory	NN
accessory	JJ
acclaim	NN
acclaim	VB
acclimate	NN
acclivity	NN
accolade	NN
accommodate	VB
accomplice	NN
accord	NN
accost	VB
accoutre	NN
accoutrements	NNS
accretion	NN
accrue	VB
acerbity	NN
acetic	JJ
acidulous	JJ
acknowledge	VB
acme	NN
acoustics	NNS
acquiesce	NN
acquiescence	NN
acquiescent	JJ
acquire	NN
acquittal	NN
acquid	NN
acrid	NN
acrimonious	JJ
acrophobia	NN
actuarial	JJ
actuate	VB
acuity	NN
acumen	NNS
acute	JJ
adage	NN
adamant	JJ
adapt	VB
addendum	NN
addiction	NN
addle	VB
address	NN
adept	JJ
adept	NN
adhere	VB
adhesion	NN
adherent	JJ
adjacent	JJ
adjunct	NN
admonish	JJ
admonition	NN
adorn	VB
adroit	JJ
adulation	NN
adulterate	VB
advent	NN
adventitious	JJ
adversary	NN
adverse	JJ
adversity	NN
advocacy	NN
advocate	NN
advocate	VB
aerie	NN
aesthetic	JJ
affable	JJ
affected	VBN
affidavit	NN
affiliation	NN
affinity	NN
affirmation	NN
affix	VB
affliction	NN
affluence	NN
affront	NN
affront	VB
aftermath	NN
agenda	NN
agent	NN
agglomeration	NN
aggrandize	VB
aggregate	NN
aggressor	NN
aghast	JJ
agility	NN
agitate	VB
agnostic	JJ
agnostic	NN
agrarian	JJ
alacrity	NN
alchemy	NN
alchemist	NN
alcove	NN
alias	NNS
alias	RB
alienate	VB
alimentary	JJ
alimony	NN
allay	VB
allege	VB
allegiance	NN
allegory	NN
alleviate	VB
alliteration	NN
allocate	VB
alloy	NN
allude	NN
allure	NN
allure	VB
allusion	NN
aloft	RB
aloof	JJ
altercation	NN
altruistic	JJ
amalgamate	NN
amass	VB
ambidextrous	JJ
ambience	NN
ambiguous	JJ
ambivalence	NN
amble	VB
amble	NN
ambulatory	JJ
ameliorate	VB
amenable	JJ
amend	VB
amenities	NNS
amiable	JJ
amicable	JJ
amiss	JJ
amiss	RB
amity	NN
amnesia	NN
amnesty	NN
amoral	JJ
amorous	JJ
amorphous	JJ
amphibian	NN
amphibian	JJ
amphitheater	NN
ample	JJ
amplify	VB
amputate	VB
amulet	NN
anachronistic	JJ
analgesic	JJ
analogous	JJ
analogy	NN
anarchist	NN
anathema	NN
ancestry	NN
anchor	NN
anchorage	NN
ancillary	NN
ancillary	JJ
anecdote	NN
anemia	NN
anemic	JJ
anesthetic	NN
anguish	NN
angular	JJ
animated	JJ
animosity	NN
animus	NN
annals	NN
annex	NN
annihilate	VB
annotate	VB
annuity	NN
annul	NN
anoint	NN
anomalous	JJ
anomaly	RB
anonymity	NN
anonymous	JJ
antagonism	NN
antecede	NN
antecedents	NNS
antediluvian	JJ
anthem	NN
anthology	NN
anthropocentric	JJ
anthropoid	NN
anthropoid	JJ
anthropologist	NN
anthropomorphic	JJ
anticlimax	NN
antidote	NN
antipathy	NN
antiquated	JJ
antiseptic	JJ
antiseptic	NN
antithesis	NN
apathy	NN
ape	NN
aperture	NN
apex	NN
aphasia	NN
aphorism	NN
apiary	NN
aplomb	NN
apocalyptic	JJ
apocryphal	JJ
apogee	NN
apolitical	JJ
apologist	NN
apostate	NN
apotheosis	NN
appall	NN
apparatus	NN
apparition	NN
appease	VB
appellation	NN
append	NN
application	NN
apposite	NN
appraise	VB
appreciate	VB
apprehend	VB
apprehension	NN
apprenticeship	NN
apprise	VB
approbation	NN
appropriate	JJ
apropos	JJ
apropos	RB
apropos	IN
aptitude	NN
aquatic	JJ
aquiline	NN
arable	JJ
arbiter	NN
arbitrary	JJ
arbitrator	NN
arbitration	NN
arboretum	NN
arcade	NN
arcane	JJ
archaeology	NN
archaic	JJ
archetype	NN
archipelago	NN
archives	NNS
ardent	JJ
arduous	JJ
aria	NN
arid	NN
aristocracy	NN
armada	NN
aromatic	JJ
arousal	NN
arraign	VB
array	NN
array	VB
arrears	NNS
arrest	NN
arrogance	NN
arroyo	NN
arsenal	NN
articulate	VB
articulate	JJ
artifact	NN
artifice	NN
artisan	NN
artless	JJ
ascendancy	NN
ascertain	VB
ascetic	JJ
ascetic	NN
ascribe	VB
aseptic	JJ
ashen	NN
asinine	NN
askance	RB
askew	NN
asperity	NN
aspirant	NN
aspirant	JJ
aspire	VB
assail	VB
assay	NN
assay	VB
assent	NN
assert	VB
assessment	NN
assiduous	JJ
assimilate	VB
assuage	VB
assumption	NN
assurance	NN
asteroid	NN
astigmatism	NN
astral	JJ
astringent	JJ
astringent	NN
astronomical	JJ
astute	JJ
asunder	NN
asylum	NN
asymmetric	JJ
atavism	NN
atheistic	JJ
atlas	NNS
atone	NN
atrocity	NN
atrophy	NN
atrophy	VB
attain	VB
attentive	JJ
attenuate	VB
attest	VB
attribute	NN
attrition	NN
atypical	JJ
audacious	JJ
audit	NN
audit	VB
auditory	NN
augment	VBP
augury	NN
august	NNP
aureole	NN
auroral	NN
auspicious	JJ
austere	JJ
authenticate	VB
authoritarian	JJ
authoritative	JJ
autocratic	JJ
automaton	NN
autonomous	JJ
autopsy	NN
autopsy	VB
auxiliary	NN
auxiliary	JJ
suxiliary	NN
avalanche	NN
avarice	NN
avenge	VB
averse	JJ
aversion	NN
avert	VB
aviary	NN
avid	JJ
avidity	NN
avocation	NN
avow	NN
avuncular	JJ
awe	NN
awry	RB
awry	JJ
axiom	NN
azure	NN
babble	NN
babble	VB
bacchanalian	JJ
badger	NN
badinage	NN
baffle	NN
bait	NN
baleful	JJ
balk	VB
ballast	NN
ballast	VB
balm	NN
balmy	NN
banal	JJ
bandy	NN
bane	NN
bantering	VBG
barb	NN
bard	NN
baroque	NN
barrage	NN
barren	JJ
barricade	NN
barricade	VB
barterer	NN
bask	VB
bastion	NN
bate	NN
bauble	NN
bawdy	JJ
beam	NN
beatific	JJ
beatitude	NN
bedizen	NN
bedraggle	NN
beeline	NN
befuddle	NN
beget	NN
begrudge	NN
beguile	VB
behemoth	NN
belabor	NN
belated	JJ
beleaguer	NN
belie	VB
belittle	NN
bellicose	NN
belligerent	JJ
bemoan	VB
bemused	JJ
benediction	NN
benefactor	NN
beneficial	JJ
beneficiary	NN
benevolent	JJ
benign	JJ
bent	JJ
bequeath	NN
berate	VB
bereavement	NN
bereft	JJ
berserk	RB
beseech	VB
beset	VBN
besiege	VB
besmirch	VB
bestial	JJ
bestow	VB
betoken	NN
betray	NN
betroth	NN
bevy	NN
biased	VBN
bicameral	JJ
bicker	NN
biennial	JJ
bigotry	NN
bilious	JJ
bilk	VB
billowing	VBG
bivouac	NN
bivouac	VB
bivoad	NN
bizarre	JJ
blanch	NN
bland	NN
blandishment	NN
blare	NN
blasé	NN
blasphemy	NN
blatant	JJ
bleak	JJ
blighted	JJ
blithe	JJ
bloated	JJ
bludgeon	VB
bluff	NN
blunder	NN
blunder	VB
blurt	VB
bluster	NN
bode	VB
bogus	JJ
bohemian	JJ
boisterous	JJ
bolster	VB
bolt	NN
bombardment	NN
bombastic	JJ
booming	VBG
boon	NN
boorish	JJ
boundless	JJ
bountiful	JJ
bourgeois	NN
bovine	NN
bowdlerize	VB
boycott	NN
braggart	NN
brandish	VB
bravado	NN
brawn	NN
brawny	JJ
brazen	VB
breach	NN
breach	VB
breadth	NN
brevity	NN
brindled	JJ
bristling	VBG
brittle	JJ
broach	VB
brochure	NN
brooch	NN
browbeat	VB
browse	VB
brunt	NN
brusque	JJ
buccaneer	NN
bucolic	JJ
buffet	NN
buffoonery	NN
bullion	NN
bulwark	NN
bumptious	JJ
bungalow	NN
bungle	NN
buoyant	JJ
bureaucracy	NN
burgeon	NN
burlesque	JJ
burly	JJ
burnish	VB
bustle	NN
buttress	VB
buttress	NN
buxom	NN
cabal	NN
cache	NN
cacophonous	JJ
cadaver	NN
cadaverous	JJ
cadence	NN
cajole	VB
calamity	NN
calculated	VBN
caldron	NN
caliber	NN
calligraphy	NN
callous	JJ
callow	NN
calorific	JJ
calumny	NN
camaraderie	NN
cameo	NN
camouflage	NN
candor	NN
canine	NN
canny	JJ
cant	NN
cantankerous	JJ
cantata	NN
canter	NN
canter	VB
canto	NN
canvass	NN
canvass	VB
capacious	JJ
Capacity	NN
capitulate	NN
caprice	NN
capricious	JJ
caption	NN
caption	VB
captivate	VB
carat	NN
cardinal	NN
cardiologist	NN
careen	VB
caricature	VB
caricature	NN
carnage	NN
carnal	NN
carnivorous	JJ
carping	NN
cartographer	NN
cascade	NN
castigate	VB
casualty	NN
cataclysm	NN
catalyst	NN
catapult	VB
catapult	NN
cataract	NN
catastrophe	NN
catcall	NN
catechism	NN
categorical	JJ
cater	VB
catharsis	NN
catholic	NN
caucus	NN
caulk	NN
causal	JJ
caustic	JJ
cavalcade	NN
cavalier	JJ
cavil	NN
cavil	VB
cede	VB
celebrated	VBN
celerity	NN
celestial	JJ
celibate	NN
censor	VB
censor	NN
censorious	JJ
censure	NN
censure	VB
centigrade	NN
centrifugal	JJ
centripetal	NN
centurion	NN
cerebral	JJ
cerebration	NN
ceremonious	JJ
certitude	NN
cessation	NN
cession	NN
chafe	VB
chafe	NN
chaff	NN
chaffing	NN
chaffing	JJ
chagrin	NN
chalice	NN
chameleon	NN
champion	NN
Chaotic	JJ
chaos	NN
charisma	NN
charlatan	NN
chary	JJ
chasm	NN
chassis	NN
chaste	JJ
chasten	VB
chastise	NN
chauvinist	NN
check	NN
checkered	JJ
cherubic	JJ
chicanery	NN
chide	VB
chimerical	JJ
chisel	VB
Chivalrous	NNP
choleric	JJ
choreography	NN
chortle	NN
chronic	JJ
chronicle	NN
chronicle	VB
churlish	JJ
cipher	NN
circuitous	JJ
circumlocution	NN
circumscribe	NN
circumspect	JJ
circumvent	VB
cistern	NN
citadel	NN
cite	VB
citation	NN
Civil	JJ
clairvoyant	JJ
clamber	NN
clamor	NN
clamor	VB
clandestine	JJ
clangor	NN
clapper	NN
clasp	NN
claustrophobia	NN
cleave	VB
Cleft	NN
Cleft	JJ
clemency	NN
clench	VB
cliché	NN
clientele	NN
climactic	JJ
clime	NN
Clip	NN
Clip	VB
clique	NN
cloister	NN
Clout	NN
cloying	JJ
Clump	NN
coagulate	VB
coalesce	NN
coalition	NN
coddle	VB
codicil	NN
codify	NN
coercion	NN
cogent	JJ
cogitate	NN
cognate	JJ
cognate	NN
cognitive	JJ
cognizance	NN
cohere	VB
cohesion	NN
coiffure	NN
coin	NN
coincidence	NN
coincidental	JJ
colander	NN
collaborate	VB
collage	NN
collate	VB
collateral	NN
colloquial	JJ
collusion	NN
colossal	JJ
comatose	NN
combustible	JJ
combustible	NN
comely	RB
comeuppance	NN
commandeer	NN
commemorate	VB
commensurate	JJ
commiserate	VB
commodious	JJ
communal	JJ
compact	JJ
comparable	JJ
compatible	JJ
compelling	JJ
compensatory	JJ
compile	VB
complacency	NN
complaisant	NN
complement	NN
complement	VB
complementary	JJ
compliance	NN
compliant	JJ
complicity	NN
component	NN
composure	NN
compound	NN
compound	VB
comprehensive	JJ
compress	NN
comprise	VBP
compromise	NN
compromise	VB
compunction	NN
compute	VB
computation	NN
concave	NN
concede	VB
conceit	NN
concentric	JJ
conception	NN
conceive	VB
concerted	JJ
concession	NN
conciliatory	JJ
concise	NN
contrived	JJ
controvert	NN
contusion	NN
conundrum	NN
convene	VB
convention	NN
conventional	JJ
converge	VB
conversant	NN
converse	NN
convert	VB
convert	NN
conversation	NN
convex	NN
conveyance	NN
conviction	NN
convivial	JJ
convoke	NN
convoluted	JJ
Copious	JJ
coquette	NN
coquette	VB
cordial	JJ
cordon	NN
cordon	VB
cornucopia	NN
corollary	NN
coronation	NN
corporeal	NN
corpulent	JJ
corpulence	NN
correlation	NN
correlate	NN
corroborate	VB
corrosive	JJ
corrugated	JJ
Cosmic	JJ
cosmos	NNS
cosmopolitan	NN
coterie	NN
countenance	VB
countermand	NN
culvert	NN
cumbersome	JJ
cumulative	JJ
cupidity	NN
curator	NN
curmudgeon	NN
cursive	NN
cursory	NN
curtail	VB
cynical	JJ
cynic	JJ
cynosure	NN
dabble	VB
dais	NN
dank	JJ
dapper	NN
dappled	JJ
daub	NN
daub	VB
daunt	VB
dauntless	JJ
dawdle	VB
deadlock	NN
deadlock	VB
deadpan	JJ
dearth	NN
debacle	NN
debase	VB
debauch	NN
debilitate	VB
debonair	NN
debris	NN
debunk	VB
debutante	NN
decadence	NN
decapitate	VB
decelerate	VB
deciduous	JJ
decimate	VB
decipher	NN
declivity	NN
decollete	NN
decomposition	NN
decorum	NN
decoy	NN
decoy	VB
decrepit	NN
decrepitude	NN
decry	NN
deducible	JJ
deface	VB
defame	VB
default	NN
defeatist	JJ
defeatist	NN
defection	NN
defer	VB
deference	NN
defiance	NN
defile	VB
definitive	JJ
deflect	VB
defoliate	VB
defray	VB
deft	JJ
defunct	JJ
defuse	VB
degenerate	NN
degradation	NN
dehydrate	VB
deify	VB
deign	NN
delectable	JJ
delete	VB
deleterious	JJ
deliberate	JJ
delineate	VB
delineation	NN
delirium	NN
delude	VB
deluge	NN
delusion	NN
delve	NN
demagogue	NN
demean	VB
demeanor	NN
demented	JJ
demise	NN
demolition	NN
demoniac	NN
demonic	JJ
demur	VB
demure	JJ
demystify	VB
denigrate	VB
denizen	NN
denotation	NN
denotation	VB
denouement	NN
denounce	VB
depict	VB
deplete	VB
deplore	NN
deploy	VB
depose	VB
deposition	NN
depravity	NN
deprecate	VB
deprecatory	JJ
depreciate	VB
depredation	NN
deranged	JJ
derelict	NN
derelict	JJ
deride	NN
derivative	NN
dermatologist	NN
derogatory	JJ
descant	NN
descant	VB
descry	NN
desecrate	VB
desiccate	VB
desolate	JJ
despise	VB
despoil	NN
despondent	JJ
despot	NN
destitute	JJ
desultory	JJ
detached	VBN
detergent	NN
determination	NN
deterrent	NN
deter	VB
detonation	NN
detraction	NN
detrimental	JJ
deviate	VB
devious	JJ
devise	VB
devoid	JJ
devotee	NN
devout	JJ
dexterous	JJ
diabolical	JJ
diagnosis	NN
discomfit	VB
discomposure	NN
disconcert	NN
disconsolate	NN
discord	NN
discordant	JJ
discount	NN
discourse	NN
discourse	VB
discredit	VB
discrepancy	NN
discrete	JJ
discretion	NN
discriminating	VBG
discursive	JJ
disdain	NN
disdain	VB
disembark	VB
disenfranchise	NN
disengage	VB
disfigure	NN
disgorge	VB
disgruntle	NN
dishearten	NN
disheveled	JJ
disinclination	NN
disingenuous	JJ
disinter	NN
disinterested	JJ
disjointed	JJ
dislodge	VB
dismantle	VB
dismay	NN
dismay	VB
dismember	VB
dismiss	VB
disparage	VB
disparate	JJ
disparity	NN
dispassionate	JJ
dispatch	VB
dispatch	NN
dispel	VB
disperse	VB
dispirited	JJ
disputatious	JJ
disquiet	NN
dissection	NN
dissemble	VB
disseminate	VB
dissent	NN
dissent	VB
dissertation	NN
dissident	NN
dissident	JJ
dissimulate	NN
dissipate	VB
dissolute	NN
dissolution	NN
dissonance	NN
dissuade	VB
distant	JJ
distend	VB
distill	NN
distinction	NN
distort	VB
distraught	NN
diurnal	JJ
diva	NN
diverge	VB
divergent	JJ
diverse	JJ
diversion	NN
divest	VB
divine	NN
divulge	VB
docile	JJ
doctrinaire	NN
doctrine	NN
document	NN
document	VB
doff	NN
dogged	VBN
doggerel	NN
dogmatic	JJ
doldrums	NNS
doleful	JJ
dolt	NN
domicile	NN
domocile	VB
domineer	NN
don	VB
doodle	NN
dormant	JJ
dormer	NN
dossier	NN
dote	NN
douse	VB
dowdy	JJ
downcast	NN
drab	JJ
draconian	JJ
dregs	NNS
drivel	NN
droll	NN
drone	NN
dross	NN
drudgery	NN
dubious	JJ
ductile	NN
dulcet	NN
dumbfound	VB
dupe	NN
dupe	VB
duplicity	NN
duration	NN
duress	NN
dutiful	JJ
dwarf	NN
dwindle	VB
dynamic	JJ
earthy	JJ
ebb	NN
ebb	VB
ebullient	JJ
eccentric	JJ
eccentricity	NN
ecclesiastic	JJ
ecclesiastic	NN
eclectic	JJ
eclipse	NN
ecologist	NN
economy	NN
ecstasy	NN
eddy	NN
edict	NN
edify	NN
eerie	JJ
efface	VB
effectual	JJ
effervescence	NN
efficacy	NN
effigy	NN
effrontery	NN
effusive	JJ
egoism	NN
egotistical	JJ
egregious	JJ
egress	NN
ejaculation	NN
elaboration	NN
elated	JJ
elegy	NN
elicit	VB
elixir	NN
ellipsis	NN
elliptical	JJ
eloquence	NN
elucidate	VB
elusive	JJ
emaciated	VBN
emanate	NN
emancipate	VB
embargo	NN
embark	VB
embed	VBN
embellish	VB
embezzlement	NN
embody	VB
embrace	VB
embroider	NN
embroil	NN
embryonic	JJ
emendation	NN
eminent	JJ
emissary	NN
emollient	JJ
emollient	NN
empathy	NN
empirical	JJ
emulate	VB
enamored	JJ
encipher	NN
enclave	NN
encomium	NN
encompass	VB
encroachment	NN
encumber	NN
endearment	NN
endemic	JJ
endorse	VB
enduring	VBG
energize	VB
enervate	VB
enfranchise	NN
engage	VB
engaging	VBG
engender	VB
engross	VB
enhance	VB
enigma	NN
enigmatic	JJ
enmity	NN
ennui	NN
enormity	NN
enrapture	NN
ensconce	NN
ensemble	NN
entail	VB
enterprising	JJ
enthrall	NN
entice	VB
entitlement	NN
entity	NN
entomology	NN
entourage	NN
entrance	NN
entreat	VB
entrepreneur	NN
enumerate	VB
enunciate	VB
eon	NN
ephemeral	JJ
epic	NN
epic	JJ
epicure	NN
epigram	NN
epilogue	NN
episodic	JJ
epistolary	JJ
epitaph	NN
epithet	NN
epitome	NN
epoch	NN
equable	JJ
equanimity	NN
equestrian	NN
equestrian	JJ
equilibrium	NN
equine	NN
equinox	NNS
equitable	JJ
equity	NN
equivocal	JJ
equivocate	VB
erode	VB
erotic	JJ
erratic	JJ
erroneous	JJ
erudite	JJ
escapade	NN
escapism	NN
eschew	VB
esoteric	JJ
espionage	NN
espouse	VB
esteem	NN
estranged	VBN
ethereal	NN
ethnic	JJ
ethos	NN
etymology	NN
eulogy	NN
euphemism	NN
euphonious	JJ
euphoria	NN
evanescent	JJ
evasive	JJ
evenhanded	JJ
evince	VB
evocative	JJ
ewe	NN
exacerbate	VB
exacting	VBG
exalt	VB
exasperate	VB
exceptionable	JJ
excerpt	NN
excerpt	VB
excise	NN
exclaim	NN
excoriate	VB
exculpate	VB
execrable	JJ
execute	VB
exegesis	NN
exemplary	JJ
exemplify	VB
exempt	JJ
exempt	VB
exertion	NN
exhaustive	JJ
exhilarating	JJ
exhort	VB
exhume	VB
exigency	NN
exodus	NN
exonerate	VB
exorbitant	JJ
exorcise	VB
exotic	JJ
expansive	JJ
expatriate	NN
expedient	NN
expedite	VB
expenditure	NN
expertise	NN
expiate	VB
expletive	NN
explicate	VB
explicit	JJ
exploit	VB
expository	JJ
exposure	NN
expropriate	VB
expunge	VB
expurgate	VB
extant	JJ
extent	NN
extenuate	NN
extol	NN
extort	VB
extradition	NN
extraneous	JJ
extrapolation	NN
extricate	VB
extrinsic	JJ
extrovert	NN
extrude	VB
exuberance	NN
exude	VB
exult	VB
fabricate	VB
facade	NN
facet	NN
facetious	JJ
facile	JJ
facilitate	VB
facsimile	NN
faction	NN
faculty	NN
fallacious	JJ
fallible	JJ
fallow	JJ
falter	VB
fanaticism	NN
fancy	NN
fancy	VB
fanfare	NN
farce	NN
fastidious	JJ
fatalism	NN
fathom	NN
fatuous	JJ
fauna	NNS
fawning	VBG
faze	VB
feasible	JJ
fecundity	NN
feign	VB
feint	NN
feint	VB
felicitous	JJ
fell	VBD
felon	NN
feral	JJ
ferment	NN
ferret	VB
fervent	JJ
fervid	JJ
fervor	NN
fester	VB
festive	JJ
fetid	JJ
fetter	NN
fiasco	NN
fickle	JJ
fictitious	JJ
fidelity	NN
figment	NN
figurative	JJ
figurine	NN
filament	NN
filch	VB
filial	JJ
filibuster	NN
finale	NN
finesse	NN
finicky	JJ
firebrand	NN
fissure	NN
fitful	JJ
flabbergasted	VBN
flaccid	JJ
flag	NN
flagrant	JJ
flair	NN
flamboyant	JJ
flaunt	VB
fleck	NN
fledgling	NN
fledgling	JJ
fleece	NN
flick	NN
flinch	VB
flippant	JJ
flit	NN
floe	NN
flora	NN
florid	JJ
flounder	VB
flourish	VB
flout	NN
fluctuate	VB
fluency	NN
fluke	NN
fluster	NN
flux	NN
fodder	NN
foible	NN
foil	NN
foliage	NN
foment	NN
foolhardy	JJ
fop	NN
forbearance	NN
ford	NN
ford	VB
forebears	NNS
foreboding	NN
forensic	JJ
foreshadow	NN
foresight	NN
forestall	NN
forgo	VB
forlorn	JJ
formality	NN
formidable	JJ
forsake	NN
forswear	NN
forte	NN
forthright	NN
fortitude	NN
fortuitous	JJ
forum	NN
foster	JJ
foster	VB
founder	NN
fracas	NN
fractious	JJ
frail	JJ
franchise	NN
frantic	JJ
fraternize	VB
fraudulent	JJ
fraught	JJ
fray	NN
frenetic	JJ
frenzied	JJ
fresco	NN
fret	NN
friction	NN
frigid	JJ
frivolous	JJ
frolicsome	JJ
frond	NN
frugality	NN
fruition	NN
frustrate	VB
fugitive	JJ
fulcrum	NN
fulsome	JJ
fundamental	JJ
furlough	NN
furor	NN
furtive	JJ
fusion	NN
futile	JJ
gadfly	NN
gaffe	NN
gainsay	NN
gait	NN
galaxy	NN
gale	NN
gall	NN
galleon	NN
galvanize	VB
gambit	NN
gamely	RB
gamut	NN
gape	NN
garbled	VBN
gargantuan	JJ
garish	JJ
garnish	NN
garner	VB
garnish	NN
garnish	VB
garrulous	JJ
gauche	NN
gaudy	JJ
gaunt	JJ
gavel	NN
gawk	NN
genealogy	NN
generality	NN
generate	VB
generic	JJ
genesis	NN
geniality	NN
genre	NN
genteel	JJ
gentility	NN
gentry	NN
germane	NN
germinal	JJ
germinate	VB
gesticulation	NN
ghastly	JJ
gibberish	NN
gibe	NN
giddy	JJ
gingerly	RB
girth	NN
gist	NN
glacial	JJ
glaring	NN
glaze	VB
glaze	NN
glib	JJ
glimmer	NN
gloat	VB
glossary	NN
gloss	VB
glossy	JJ
glower	NN
glut	NN
glut	VB
glutton	NN
gnarled	VBN
gnome	NN
goad	NN
goad	VB
gorge	NN
gory	NN
gouge	NN
gourmand	NN
gourmet	NN
graduated	VBN
graft	NN
graft	VB
grandeur	NN
grandiloquent	JJ
grandiose	JJ
granulate	NN
graphic	JJ
grapple	VB
grate	NN
gratify	NN
gratis	NN
gratis	JJ
gratuitous	JJ
gravity	NN
gregarious	JJ
grievance	NN
grill	NN
grimace	VB
grimace	NN
grisly	JJ
grouse	NN
grotesque	JJ
grove	NN
grovel	NN
grudging	JJ
gruel	NN
gruel	VB
grueling	VBG
gruesome	JJ
gruff	JJ
guffaw	NN
guffaw	VB
guile	NN
guileless	JJ
guise	NN
gullible	JJ
gustatory	NN
gusto	NN
gusty	NN
hackneyed	JJ
haggard	NN
haggle	VB
hallowed	JJ
hallucination	NN
halting	VBG
hamper	VB
haphazard	NN
harangue	NN
harangue	VB
harass	VB
harbinger	NN
harbor	NN
hardy	JJ
harrowing	JJ
haughtiness	NN
hazardous	JJ
hazy	NN
headlong	RB
headstrong	NN
heckler	NN
hedonist	NN
heed	VB
heed	NN
heedless	JJ
heinous	JJ
herbivorous	JJ
heresy	NN
hermetic	JJ
hermitage	NN
heterodox	NN
heterogeneous	JJ
heyday	NN
hiatus	NN
hibernal	NN
hibernate	VB
hierarchy	NN
hilarity	NN
hindrance	NN
histrionic	JJ
hoard	NN
hoard	VB
hoary	JJ
hoax	NN
hoax	VB
hodgepodge	NN
holster	NN
homage	NN
homogeneous	JJ
hone	VB
hoodwink	NN
horde	NN
horticultural	JJ
host	NN
hostility	NN
hovel	NN
hover	NN
hue	NN
hulking	VBG
humane	NN
humdrum	JJ
humid	JJ
humility	NN
hurtle	NN
husband	NN
hybrid	NN
hybrid	JJ
hydrophobia	NN
hyperbole	NN
hypercritical	JJ
hypochondriac	NN
hypocritical	JJ
hypothetical	JJ
ichthyology	NN
icon	NN
iconoclastic	JJ
ideology	NN
idiom	NN
idiosyncrasy	NN
idolatry	NN
ignite	VB
ignoble	JJ
ignominy	NN
illicit	JJ
illimitable	JJ
illuminate	VB
illusion	NN
illusory	JJ
imbalance	NN
imbibe	NN
immaculate	JJ
imminent	JJ
immobility	NN
immune	JJ
immutable	JJ
impair	VB
impale	VB
impalpable	JJ
impart	VB
impartial	JJ
impassable	JJ
impasse	NN
impassive	JJ
impeach	VB
impeccable	JJ
impecunious	JJ
impede	VB
impediment	NN
impel	VB
impenetrable	JJ
impending	VBG
impenitent	JJ
imperative	JJ
imperative	NN
imperceptible	JJ
imperial	JJ
imperious	JJ
impermeable	JJ
impertinent	JJ
imperturbable	JJ
Impervious	JJ
impetuous	JJ
impetus	NN
impiety	NN
impinge	VB
impious	JJ
implacable	JJ
implausible	JJ
implement	VB
implement	NN
implicate	VBP
implication	NN
implicit	JJ
implore	NN
imply	VBP
importunate	NN
importune	NN
impostor	NN
impotent	JJ
impoverished	JJ
impregnable	JJ
impromptu	JJ
impropriety	NN
improvident	JJ
improvise	VB
imprudent	JJ
impudence	NN
impugn	VB
impunity	NN
inadvertently	RB
inalienable	JJ
inane	NN
inanimate	NN
inarticulate	JJ
inaugurate	VB
incandescent	NN
incantation	NN
incapacitate	VB
incarcerate	VB
incarnation	NN
incendiary	JJ
incendiary	NN
incense	NN
incentive	NN
inception	NN
incessant	JJ
inchoate	NN
incidence	NN
incidental	JJ
incipient	JJ
incisive	JJ
incite	VB
inclement	NN
incline	NN
inclined	JJ
incline	VB
inclusive	JJ
incoherent	JJ
incompatible	JJ
incongruous	JJ
inconsequential	JJ
inconsistency	NN
incontinent	JJ
incontrovertible	JJ
incorporate	VB
incorporate	JJ
incorporeal	NN
incorrigible	JJ
incredulous	JJ
increment	NN
incriminate	VB
incrustation	NN
incubate	VB
inculcate	VB
incumbent	JJ
incumbent	NN
incur	VB
incursion	NN
indefatigable	JJ
indelible	JJ
indentation	NN
indenture	NN
indenture	VB
indeterminate	JJ
indicative	JJ
indices	NNS
indict	VB
indifferent	JJ
indigenous	JJ
indigent	NN
indignation	NN
indignity	NN
indiscretion	NN
indiscriminate	JJ
indisputable	JJ
indissoluble	JJ
indoctrinate	NN
indolent	JJ
indomitable	JJ
indubitable	JJ
induce	VB
indulgent	JJ
industrious	JJ
inebriated	VBN
ineffable	JJ
ineffectual	JJ
inefficacious	JJ
inept	JJ
inequity	NN
inert	JJ
inevitable	JJ
inexorable	JJ
infallible	JJ
infamous	JJ
infantile	JJ
infer	VB
infernal	JJ
infidel	NN
infiltrate	NN
infinitesimal	JJ
infirmity	NN
inflated	JJ
influx	NN
informal	JJ
infraction	NN
infuriate	VB
infusion	NN
ingenious	JJ
ingenue	NN
ingenuous	JJ
ingrained	VBN
ingrate	NN
ingratiate	VB
inherent	JJ
inhibit	VB
inimical	JJ
inimitable	JJ
iniquitous	JJ
initiate	NN
injurious	JJ
inkling	NN
innate	JJ
innocuous	JJ
innovation	NN
innovative	JJ
innuendo	NN
inopportune	NN
inordinate	JJ
inquisitor	NN
insalubrious	JJ
insatiable	JJ
inscrutable	JJ
insensible	JJ
insidious	JJ
insightful	JJ
insinuate	NN
insipid	NN
insolence	NN
insolvent	JJ
insomnia	NN
instigate	NN
insubordination	NN
insubstantial	JJ
insularity	NN
insulated	VBN
insuperable	JJ
insurgent	NN
insurmountable	JJ
insurrection	NN
intangible	JJ
integral	JJ
integrate	VB
integrity	NN
intellect	NN
intelligentsia	NN
intemperate	JJ
inter	NN
interim	NN
interloper	NN
interment	NN
interminable	JJ
intermittent	JJ
interrogate	VB
intervene	VB
intimacy	NN
intimidate	VB
intractable	JJ
intransigence	NN
intrepid	JJ
intricate	JJ
intrinsic	JJ
introspective	JJ
introspective	JJ
introspective	VB
intrude	VB
intuition	NN
inundate	VB
inured	VBN
invalidate	VB
invasive	JJ
invective	NN
inverse	JJ
invert	NN
invidious	JJ
invigorate	VB
invincible	JJ
inviolable	JJ
invocation	NN
invoke	VB
invulnerable	JJ
iota	NN
irascible	JJ
irate	JJ
ire	NN
iridescent	JJ
irksome	JJ
ironic	JJ
irony	NN
irrational	JJ
irreconcilable	JJ
irrefutable	JJ
irrelevant	JJ
irremediable	JJ
irreparable	JJ
irrepressible	JJ
irreproachable	JJ
irresolute	JJ
irretrievable	JJ
irreverence	NN
irrevocable	JJ
itinerant	NN
itinerant	JJ
itinerary	NN
jabber	NN
jaded	VBN
jargon	NN
jaundiced	JJ
jaunt	NN
jaunty	JJ
jeopardize	VB
jettison	NN
jingoist	NN
jocose	NN
jocular	JJ
jollity	NN
jostle	VB
jovial	JJ
jubilation	NN
judicious	JJ
juncture	NN
junta	NN
jurisprudence	NN
justification	NN
kaleidoscope	NN
kernel	NN
killjoy	NN
kindle	NN
kindred	NN
kindred	JJ
kinetic	JJ
kleptomaniac	NN
knave	NN
knit	VBN
knoll	NN
knotty	JJ
kudos	NNS
laborious	JJ
labyrinth	NN
laceration	NN
lachrymose	NN
lackadaisical	JJ
lackluster	NN
laconic	JJ
laggard	NN
lament	NN
lampoon	NN
lampoon	VB
languid	JJ
languish	VB
languor	NN
lap	NN
larceny	NN
larder	NN
largess	NN
lassitude	NN
latent	JJ
lateral	NN
latitude	NN
laud	NN
lavish	JJ
lavish	VB
Iax	NN
leaven	VB
lechery	NN
leery	JJ
legacy	NN
legend	NN
legerdemain	NN
leniency	NN
lethal	JJ
lethargic	JJ
levitate	NN
levity	NN
levy	NN
lewd	JJ
lexicographer	NN
lexicon	NN
liability	NN
liaison	NN
libel	NN
liberator	NN
libretto	NN
licentious	JJ
lilliputian	JJ
lilliputian	NN
limber	JJR
limerick	NN
limpid	JJ
linchpin	NN
lineage	NN
linger	VB
linguistic	JJ
liniment	NN
lionize	VB
liquidate	VB
list	NN
listless	JJ
litany	NN
lithe	NN
litigation	NN
livid	JJ
loath	JJ
loathe	NN
lofty	JJ
log	NN
loiter	NN
loll	NN
longevity	NN
loom	VB
lope	NN
lout	NN
low	JJ
lucid	JJ
lucrative	JJ
ludicrous	JJ
lugubrious	JJ
lull	NN
lumber	NN
luminary	NN
luminous	JJ
lummox	NN
lunar	NN
lunge	NN
lurid	NN
lurk	VB
luscious	JJ
luster	NN
lustrous	JJ
luxuriant	JJ
machinations	NNS
madrigal	NN
maelstrom	NN
magnanimous	JJ
magnate	NN
magnitude	NN
maim	VB
maladroit	NN
malady	NN
malaise	NN
malapropism	NN
malcontent	NN
malcontent	JJ
malediction	NN
malefactor	NN
malevolent	JJ
malfeasance	NN
malicious	JJ
malign	NN
malignant	JJ
malingerer	NN
malleable	JJ
malodorous	JJ
mammal	NN
mammoth	JJ
mandate	NN
mandate	VB
mandatory	JJ
maniacal	JJ
manifest	JJ
manifesto	NN
manipulate	VB
mannered	JJ
marital	JJ
maritime	NN
marked	JJ
marquee	NN
marred	VBN
marshal	NN
marsupial	NN
martial	NN
martinet	NN
martyr	NN
masochist	NN
material	NN
materialism	NN
maternal	JJ
matriarch	NN
matriculate	VB
maudlin	NN
maul	VB
maverick	NN
mawkish	JJ
maxim	NN
meager	JJ
meander	VB
meddlesome	NN
mediate	VB
mediocre	JJ
meditation	NN
medley	NN
meek	NN
melancholy	JJ
mellifluous	JJ
membrane	NN
memento	NN
menagerie	NN
mendacious	JJ
mendicant	NN
menial	JJ
mentor	NN
mercenary	JJ
mercurial	JJ
merger	NN
mesmerize	VB
metallurgical	JJ
metamorphosis	NN
metaphor	NN
metaphysical	JJ
methodical	JJ
meticulous	JJ
metropolis	NN
mettle	NN
miasma	NN
microcosm	NN
migrant	NN
migrant	JJ
migratory	JJ
milieu	NN
militant	JJ
militant	NN
mimicry	NN
mincing	VBG
minuscule	JJ
minute	NN
minutiae	NNS
mirage	NN
mire	NN
mire	VB
mirth	NN
misanthrope	NN
misapprehension	NN
miscellany	NN
mischance	NN
misconception	NN
misconstrue	NN
misdemeanor	NN
miserly	JJ
misgivings	NNS
mishap	NN
misnomer	NN
misrepresent	VB
missile	NN
missive	NN
mite	JJ
mitigate	VB
mnemonic	JJ
mobile	JJ
mock	JJ
mode	NN
modicum	NN
modulate	VB
molecule	NN
mollify	VB
molt	NN
molten	NN
momentous	JJ
momentum	NN
monarchy	NN
monastic	JJ
monetary	JJ
monochromatic	JJ
monolithic	JJ
monosyllabic	JJ
monotony	NN
montage	NN
monumental	JJ
moodiness	NN
moratorium	NN
morbid	JJ
mores	NNS
moribund	JJ
morose	NN
mortician	NN
mortify	NN
mosaic	NN
mote	NN
motif	NN
motley	NN
mottled	VBN
muddle	NN
muddle	VB
muggy	JJ
multifaceted	JJ
multifarious	JJ
multiform	NN
multilingual	JJ
multiplicity	NN
mundane	JJ
munificent	JJ
mural	NN
murky	JJ
muse	NN
muse	VB
mushroom	NN
musky	NN
muster	NN
muster	VB
musty	JJ
mutability	NN
muted	VBN
mutinous	JJ
myopic	JJ
myriad	JJ
myriad	NN
mystify	VB
nadir	NN
naiveté	NN
narcissist	NN
narrative	NN
nascent	JJ
natty	JJ
nauseate	VB
nautical	JJ
navigable	JJ
nebulous	JJ
necromancy	NN
nefarious	JJ
negate	VB
negligence	NN
negligible	JJ
nemesis	NN
neologism	NN
neophyte	JJ
nepotism	NN
nettle	NN
neutral	JJ
nicety	NN
nihilist	NNP
nip	NN
nirvana	NN
nocturnal	JJ
noisome	JJ
nomadic	JJ
nomenclature	NN
nominal	JJ
nonchalance	NN
noncommittal	JJ
nondescript	JJ
nonentity	NN
nonplus	JJ
nostalgia	NN
notable	JJ
notoriety	NN
novelty	NN
novice	NN
noxious	JJ
nuance	NN
nullify	VB
numismatist	NN
nuptial	JJ
nurture	VB
nurture	NN
nutrient	NN
oaf	NN
obdurate	JJ
obese	JJ
obfuscate	VB
obituary	NN
obituary	JJ
objective	NN
obligatory	JJ
oblique	JJ
obliterate	VB
oblivion	NN
oblivious	JJ
obnoxious	JJ
obscure	JJ
obsequious	JJ
obsessive	JJ
obsolete	JJ
obstetrician	NN
obstinate	JJ
obstreperous	JJ
obtrude	NN
obtuse	JJ
obviate	VB
odious	JJ
odium	NN
odorous	JJ
odyssey	NN
offensive	NN
offhand	RB
officious	JJ
ogle	NN
olfactory	JJ
oligarchy	NN
ominous	JJ
omnipotent	JJ
omnipresent	JJ
omniscient	JJ
omnivorous	JJ
onerous	JJ
onset	NN
onus	NN
opalescent	NN
opaque	JJ
opiate	VB
opportune	JJ
opportunist	NN
optician	NN
optimist	NN
optimum	NN
optimum	JJ
optional	JJ
opulence	NN
opus	NN
oracular	JJ
orator	NN
ordeal	NN
ordinance	NN
ordination	NN
orgy	NN
orient	NN
orientation	NN
ornate	NN
ornithologist	NN
ornithology	NN
orthodox	NN
oscillate	VB
ossify	VB
ostensible	JJ
ostentatious	JJ
ostracize	VB
oust	VB
outlandish	JJ
outmoded	JJ
outskirts	NNS
outspoken	JJ
outstrip	NN
outwit	NN
ovation	NN
overbearing	VBG
overt	JJ
overwrought	JJ
pachyderm	NN
pacifist	NN
pacify	NN
pact	NN
paean	NN
painstaking	NN
palatable	JJ
paleontology	NN
palette	NN
pall	NN
palliate	VB
pallid	JJ
palpable	JJ
palpitate	VB
paltry	JJ
pan	NN
panacea	NN
panache	NN
pandemic	NN
pandemonium	NN
pander	NN
panegyric	NN
panoramic	JJ
pantomime	NN
pantomime	vb
papyrus	NN
parable	NN
paradigm	NN
paradox	NN
paragon	NN
parallelism	NN
paramount	JJ
paranoia	NN
paraphernalia	NN
paraphrase	NN
paraphrase	VB
parasite	NN
parched	VBN
pariah	NN
parity	NN
parochial	JJ
parody	NN
paroxysm	NN
parry	VB
parsimony	NN
partial	JJ
partiality	NN
partisan	JJ
partisan	NN
partition	NN
partition	VB
passive	NN
passport	NN
pastiche	NN
pastoral	NN
patent	NN
patent	VB
pathetic	JJ
pathological	JJ
pathos	NN
patina	NN
patriarch	NN
patrician	NN
patrician	JJ
patronize	VB
paucity	NN
pauper	NN
peccadillo	NN
pecuniary	JJ
pedagogy	NN
pedant	NN
pedantic	JJ
pedestrian	NN
pediatrician	NN
peerless	JJ
pejorative	JJ
pellucid	JJ
penchant	NN
pendant	NN
penitent	JJ
penitent	NN
pensive	JJ
penury	NN
perceptive	JJ
percussion	NN
percussion	JJ
perdition	NN
peregrination	NN
peremptory	JJ
perennial	JJ
perennial	NN
perfidious	JJ
perforate	VB
perfunctory	JJ
perimeter	NN
peripheral	JJ
periphery	NN
perjury	NN
permeable	JJ
permeate	VB
pernicious	JJ
perpetrate	VB
perpetual	JJ
perpetuate	VB
perquisite	NN
persona	NN
personable	JJ
perspicacious	JJ
pert	JJ
pertinacious	JJ
pertinent	JJ
perturb	VB
peruse	VB
pervasive	JJ
perverse	JJ
pessimism	NN
petrify	NN
petty	NN
petulant	JJ
phenomena	NNS
philanderer	NN
philanthropist	NN
philistine	JJ
philology	NN
phlegmatic	JJ
phobia	NN
phoenix	NN
phylum	NN
physiological	JJ
picaresque	NN
piebald	NN
piecemeal	RB
pied	VBN
pigment	NN
pillage	NN
pine	VB
pinnacle	NN
pious	JJ
piquant	JJ
pique	NN
pique	VB
pitfall	NN
pithy	JJ
pittance	NN
pivotal	JJ
placate	VB
placebo	NN
placid	JJ
plagiarism	NN
plagiarize	VB
plaintive	JJ
plasticity	NN
platitude	NN
plaudit	NN
plausible	JJ
plenitude	NN
plethora	NN
pliable	JJ
pliant	JJ
plight	NN
plumb	NN
plumb	JJ
plumb	VB
plumage	NN
plummet	VB
plutocracy	NN
podiatrist	NN
podium	NN
poignancy	NN
polarize	VB
polemical	JJ
politic	NN
polygamist	NN
polyglot	NN
pomposity	NN
ponderous	JJ
pontifical	JJ
pore	NN
porous	JJ
portend	VB
portent	NN
portly	JJ
poseur	NN
posterity	NN
posthumous	JJ
postulate	VB
potable	JJ
potable	NN
potent	JJ
potentate	NN
potential	NN
potential	JJ
potion	NN
practicable	JJ
practical	JJ
practitioner	NN
pragmatic	JJ
pragmatist	NN
prank	NN
prate	NN
prattle	NN
preamble	NN
precarious	JJ
precedent	NN
precept	NN
precinct	NN
precipice	NN
precipitate	NN
precipitous	JJ
précis	NN
precise	JJ
preclude	VB
precocious	JJ
precursor	NN
predator	NN
predecessor	NN
predetermine	NN
predicament	NN
predilection	NN
predispose	VB
preeminent	JJ
preempt	VB
preen	VB
prehensile	NN
prelate	NN
prelude	NN
premeditate	VB
premise	NN
premonition	NN
preposterous	JJ
prerogative	NN
presage	VB
prescience	NN
presentiment	NN
prestige	NN
presumptuous	JJ
pretentious	JJ
preternatural	JJ
pretext	NN
prevail	VB
prevalent	JJ
prevaricate	VB
prey	NN
prey	VB
prim	JJ
primordial	JJ
primp	NN
pristine	JJ
privation	NN
probe	NN
probe	VB
problematic	JJ
proclivity	NN
procrastinate	VB
prod	NN
prodigal	JJ
prodigal	NN
prodigious	JJ
prodigy	NN
profane	NN
profane	JJ
profligate	NN
profound	JJ
profusion	NN
progenitor	NN
progeny	NN
prognosis	NN
projectile	NN
proletarian	JJ
proliferation	NN
prolific	JJ
prolixity	NN
prologue	NN
prolong	VB
prominent	JJ
promiscuous	JJ
promontory	NN
promote	VB
prompt	JJ
promulgate	VB
prone	JJ
propagate	VB
propellants	NNS
propensity	NN
prophetic	JJ
propinquity	NN
propitiate	VB
propitious	JJ
proponent	NN
propound	VB
propriety	NN
propulsive	JJ
prosaic	JJ
proscribe	NN
proselytize	VB
prosperity	NN
prostrate	VB
prostrate	JJ
protean	JJ
protégé	NN
protocol	NN
prototype	NN
protract	VB
protrude	NN
protuberance	NN
provident	NN
provincial	JJ
provisional	JJ
provoke	VB
prowess	NN
proximity	NN
proxy	NN
prude	NN
prudent	JJ
prune	VB
prurient	JJ
pseudonym	NN
psyche	NN
pterodactyl	NN
puerile	JJ
pugilist	NN
pugnacity	NN
pulchritude	NN
pulverize	VB
pummel	VB
punctilious	JJ
pundit	NN
pungent	JJ
punitive	JJ
puny	JJ
purchase	NN
purge	NN
purported	JJ
purse	NN
purveyor	NN
pusillanimous	JJ
putrid	JJ
pyromaniac	NN
quack	UH
quadruped	NN
quaff	NN
quagmire	NN
quail	NN
quaint	JJ
qualified	VBN
qualms	NNS
quandary	NN
quarantine	NN
quarantine	VB
quarry	NN
quarry	VB
quay	NN
queasy	NN
quell	VB
quench	VB
querulous	JJ
query	NN
quibble	NN
quibble	VB
quiescent	JJ
quietude	NN
quintessence	NN
quip	NN
quip	VB
quirk	NN
quiver	NN
quiver	VB
quixotic	JJ
quizzical	JJ
quorum	NN
rabid	JJ
raconteur	NN
rail	NN
raiment	NN
rally	NN
ramble	VB
ramification	NN
ramify	NN
ramp	NN
rampant	JJ
ramshackle	JJ
rancid	JJ
rancor	NN
random	JJ
rankle	VB
rant	NN
rapacious	JJ
rapport	NN
rapt	JJ
rarefied	VBN
raspy	JJ
ratify	VB
ratiocination	NN
rationale	NN
rationalize	VB
raucous	JJ
rave	VB
ravel	NN
ravenous	JJ
raze	VB
reactionary	JJ
realm	NN
reaper	NN
rebuff	NN
rebuff	VB
rebuke	NN
rebuke	VB
rebuttal	NN
recalcitrant	JJ
recant	NN
recapitulate	VB
recast	NN
receptive	JJ
recession	NN
recidivism	NN
recipient	JJ
reciprocal	JJ
reciprocate	NN
recluse	NN
reconcile	VB
reconnaissance	NN
recount	NN
recourse	NN
recrimination	NN
rectify	VB
rectitude	NN
recumbent	NN
recuperate	VB
recurrent	JJ
redolent	NN
redoubtable	JJ
redress	NN
redress	VB
redundant	JJ
reek	NN
reek	VB
refraction	NN
refractory	JJ
refrain	NN
refurbish	VB
refute	VB
regal	NN
regale	VB
regime	NN
regimen	NNS
rehabilitate	VB
reimburse	VB
reiterate	VB
rejoinder	NN
rejuvenate	VB
relegate	NN
relent	VB
relevant	JJ
relic	NN
relinquish	VB
relish	NN
relish	VB
remediable	JJ
remedial	JJ
reminiscence	NN
remiss	NN
remission	NN
remnant	NN
remonstrance	NN
remorse	NN
remunerative	JJ
rend	NN
render	VB
rendition	NN
renegade	NN
renegade	JJ
renege	VB
renounce	VB
renovate	VB
renown	NN
rent	NN
reparable	JJ
reparation	NN
repast	NN
repeal	NN
repel	VB
repellent	NN
repellent	JJ
repercussion	NN
repertoire	NN
replenish	VB
replete	JJ
replica	NN
replicate	VB
repository	NN
reprehensible	JJ
repress	VB
reprieve	NN
reprieve	VB
reprimand	NN
reprimand	VB
reprisal	NN
reprise	NN
reproach	NN
reprobate	NN
reprove	VB
repudiate	VB
repugnant	JJ
repulsion	NN
reputable	JJ
reputed	VBN
requiem	NN
requisite	JJ
requite	VB
rescind	VB
resentment	NN
reserve	NN
residue	NN
resigned	VBD
resilient	JJ
resolution	NN
resolve	NN
resonant	JJ
respiration	NN
respite	NN
resplendent	NN
responsiveness	NN
restitution	NN
restive	JJ
restraint	NN
resumption	NN
resurge	VB
retain	VB
retaliation	NN
retentive	JJ
reticence	NN
retinue	NN
retiring	VBG
retort	NN
retort	VB
retract	VB
retrench	VB
retribution	NN
retrieve	VB
retroactive	JJ
retrograde	NN
retrograde	JJ
retrograde	VB
retrospective	NN
revelry	NN
reverent	JJ
reverie	NN
revert	VB
revile	VB
revoke	VB
revulsion	NN
rhapsodize	NN
rhetoric	NN
rhetorical	JJ
ribald	JJ
riddle	NN
rider	NN
rife	JJ
rift	NN
rig	NN
rigid	JJ
rigor	NN
rigorous	JJ
rile	VB
riveting	JJ
rivulet	NN
robust	JJ
roil	VB
roster	NN
rostrum	NN
rote	NN
rotundity	NN
rousing	NN
rout	NN
rout	VB
rubble	NN
ruddy	NN
rudimentary	JJ
rue	NN
ruffian	NN
ruminate	VB
rummage	NN
rummage	VB
ruse	NN
rustic	JJ
ruthless	JJ
saboteur	NN
saccharine	JJ
sacrilegious	JJ
sacrosanct	JJ
sadistic	JJ
saga	NN
Sagacious	JJ
sage	NN
sage	JJ
salacious	JJ
salient	JJ
salubrious	JJ
salutary	JJ
salvage	NN
salvage	VB
salvo	NN
sanctimonious	JJ
sanction	NN
sanctuary	NN
sanguine	JJ
sap	VB
sarcasm	NN
sardonic	JJ
sartorial	JJ
sate	VB
satellite	NN
satiate	VB
satire	NN
satirical	JJ
saturate	VB
saturnine	NN
saunter	NN
savant	NN
savor	VB
savory	JJ
scabbard	NN
scad	NN
scaffold	NN
scale	NN
scamp	NN
scanty	JJ
scapegoat	NN
scavenge	NN
scenario	NN
schematic	JJ
schism	NN
scintillate	VB
scoff	VB
scourge	NN
scourge	VB
scruple	NN
scruple	VB
scrupulous	JJ
scrutinize	VB
scuffle	NN
scurry	VB
scurvy	NN
scuttle	VB
seamy	NN
seasoned	JJ
secession	NN
seclusion	NN
secrete	VB
sectarian	NN
secular	JJ
sedate	JJ
sedentary	JJ
sedition	NN
sedulous	JJ
seedy	NN
seemly	RB
seep	NN
seethe	VB
seismic	JJ
seminary	JJ
sensual	JJ
sententious	JJ
sentinel	NN
sequester	VB
serendipity	NN
serenity	NN
serrated	JJ
servile	JJ
servitude	NN
sever	VB
severity	NN
shackle	NN
shackle	VB
sham	NN
sham	VB
shambles	NN
shard	NN
sheaf	NN
shear	NN
sheathe	NN
sheer	NN
shimmer	NN
shimmer	VB
shirk	VB
shoddy	JJ
shrewd	JJ
shroud	NN
shun	VB
shyster	NN
sibling	NN
simian	JJ
simile	NN
simper	NN
Simplistic	NNP
simulate	VB
sinecure	NN
sinewy	JJ
singular	JJ
sinister	JJ
sinuous	JJ
skeptic	NN
skiff	NN
skimp	NN
skinflint	NN
skirmish	NN
skirmish	VB
skulk	NN
slacken	NN
slag	NN
slake	VB
slander	NN
slander	VB
slapdash	JJ
sleeper	NN
sleight	NN
slight	JJ
slight	VB
slipshod	JJ
slither	NN
slothful	JJ
slough	NN
slovenly	RB
sluggard	NN
sluggish	JJ
slur	NN
slur	VB
smelt	VBN
smirk	NN
smirk	VB
smolder	VB
snicker	NN
snicker	VB
snivel	NN
sodden	JJ
sojourn	NN
solace	NN
solder	NN
solecism	NN
solemnity	NN
solicit	VB
solicitous	JJ
soliloquy	NN
solitude	NN
soluble	JJ
solvent	JJ
somber	JJ
somnambulist	JJ
somnolent	JJ
sonorous	JJ
sophisticated	JJ
sophistry	NN
sophomoric	JJ
soporific	JJ
soporific	NN
sordid	JJ
sovereign	JJ
sovereign	NN
spangle	NN
sparse	JJ
spartan	NN
spasmodic	JJ
spat	NN
spate	NN
spatial	JJ
spatula	NN
spawn	VB
spawn	NN
specious	JJ
spectrum	NN
spendthrift	NN
sphinx-like	JJ
splice	NN
splice	VB
spontaneity	NN
sporadic	JJ
sportive	JJ
spry	JJ
spurious	JJ
spurn	VB
squabble	NN
squalor	NN
squander	NN
squat	JJ
staccato	NN
stagnant	JJ
staid	VBN
stalemate	NN
stalwart	NN
stalwart	JJ
stamina	NN
stanch	VB
stanza	NN
static	JJ
statute	NN
steadfast	JJ
stealth	NN
steep	JJ
stellar	JJ
stem	NN
stereotype	NN
stifle	VB
stigma	NN
stigmatize	VB
stilted	JJ
stint	NN
stint	VB
stipend	NN
stipulate	VB
stodgy	JJ
Stoic	JJ
Stoic	NN
stoke	VB
stolid	JJ
stratagem	NN
stratify	NN
stratum	NN
strew	VB
striated	JJ
stricture	NN
strident	JJ
stringent	JJ
strut	NN
strut	VB
studied	VBN
stultify	NN
stupefy	NN
stupor	NN
stymie	NN
stymie	VB
suavity	NN
subdued	VBN
subjective	JJ
subjugate	VB
sublime	JJ
subliminal	JJ
submissive	JJ
subordinate	NN
suborn	VB
subpoena	NN
subpoena	VB
subsequent	JJ
subservient	JJ
subside	VB
subsidiary	NN
subsidiary	JJ
subsidy	NN
subsistence	NN
substantial	JJ
substantiate	VB
substantive	JJ
subterfuge	NN
subtlety	NN
subversive	JJ
succinct	JJ
succor	NN
succor	VB
succulent	JJ
succulent	NN
succumb	VB
suffragist	NN
sully	RB
sultry	JJ
summation	NN
summit	NN
sumptuous	JJ
sunder	NN
supercilious	JJ
superficial	JJ
superfluous	JJ
superimpose	NN
supersede	VB
supplant	NN
supple	JJ
supplicate	NN
supposition	NN
suppress	VB
surfeit	NN
surfeit	VB
surly	JJ
surmise	NN
surmise	VB
surmount	NN
surpass	VB
surreptitious	JJ
surrogate	NN
surveillance	NN
susceptible	JJ
sustain	VB
sustenance	NN
suture	NN
suture	VB
swagger	NN
swagger	VB
swarm	NN
swarm	VB
swarthy	NN
swathe	NN
swelter	NN
swerve	VB
swill	NN
swindler	NN
sybarite	NN
sycophant	NN
symbiosis	NN
symmetry	NN
synoptic	JJ
synthesis	NN
table	NN
tacit	JJ
taciturn	NN
tactile	JJ
taint	NN
talisman	NN
talon	NN
tangential	JJ
tangible	JJ
tanner	NN
tantalize	VB
tantamount	JJ
tantrum	NN
tarantula	NN
tarry	NN
taut	JJ
tautological	JJ
tautology	NN
tawdry	JJ
tedious	JJ
temerity	NN
temper	NN
temperament	NN
temperate	JJ
tempestuous	JJ
tempo	NN
temporal	JJ
temporize	VB
tenacious	JJ
tenacity	NN
tendentious	JJ
tender	NN
tenet	NN
tensile	NN
tenuous	JJ
tenure	NN
tepid	JJ
termination	NN
terminology	NN
terrestrial	NN
terse	JJ
testy	JJ
tether	VB
thematic	JJ
theocracy	NN
theoretical	JJ
therapeutic	JJ
thermal	JJ
thermal	NN
thespian	JJ
thespian	NN
threadbare	JJ
thrifty	NN
thrive	VB
throes	NNS
throng	NN
throng	VB
thwart	VB
tightwad	NN
tiller	NN
timidity	NN
timorous	JJ
tirade	NN
titanic	JJ
title	NN
titter	NN
titter	VB
titular	JJ
toady	NN
toady	VB
tome	NN
tonic	NN
tonic	JJ
topography	NN
torpor	NN
torrent	NN
torrid	JJ
torso	NN
tortuous	JJ
totter	VB
touchstone	NN
touchy	JJ
tout	VB
toxic	JJ
tract	NN
tractable	JJ
traduce	VB
trajectory	NN
tranquillity	NN
transcendent	JJ
transcribe	VB
transgression	NN
transient	JJ
transition	NN
transitory	JJ
translucent	JJ
transmute	NN
transparent	JJ
transport	NN
transport	VB
trappings	NNS
traumatic	JJ
travail	NN
traverse	NN
travesty	NN
treacly	RB
treatise	NN
trek	NN
trek	VB
tremor	NN
tremulous	JJ
trenchant	JJ
trepidation	NN
trespass	NN
trespass	VB
tribute	NN
trifling	JJ
trigger	NN
trinket	NN
trite	NN
trivial	JJ
trough	NN
truculence	NN
truism	NN
truncate	VB
tryst	NN
tumult	NN
tundra	NN
turbid	NN
turbulence	NN
turgid	JJ
turmoil	NN
turncoat	NN
turpitude	NN
tutelage	NN
tycoon	NN
typhoon	NN
tyranny	NN
tyro	NN
ubiquitous	JJ
ulterior	JJ
ultimate	JJ
unaccountable	JJ
unanimity	NN
unassailable	JJ
unassuming	JJ
unbridled	JJ
uncanny	JJ
unconscionable	JJ
uncouth	JJ
Unctuous	NNP
underlying	VBG
undermine	VB
underscore	VB
undulating	VBG
unearth	NN
unequivocal	JJ
unerringly	RB
unfathomable	JJ
unfetter	NN
unfrock	NN
ungainly	JJ
uniformity	NN
unimpeachable	JJ
uninhibited	JJ
unintimidating	JJ
unique	JJ
universal	JJ
unkempt	JJ
unmitigated	JJ
unobtrusive	JJ
unpalatable	JJ
unprecedented	JJ
unprepossessing	VBG
unravel	VB
unrequited	JJ
unruly	JJ
unscathed	JJ
unseemly	JJ
unsightly	JJ
unstinting	JJ
untenable	JJ
unwarranted	JJ
unwieldy	JJ
unwitting	JJ
upbraid	NN
upshot	NN
urbane	NN
usurp	VB
utopia	NN
vacuous	JJ
vagabond	NN
vagabond	JJ
vagrant	JJ
valedictory	JJ
valid	JJ
validate	VB
valor	NN
vampire	NN
vanguard	NN
vantage	NN
vapid	NN
vaporize	VB
variegated	VBN
veer	VB
vehement	JJ
velocity	NN
venal	JJ
vendetta	NN
vendor	NN
veneer	NN
venerable	JJ
venerate	VB
venial	JJ
venom	NN
vent	VB
ventriloquist	NN
venturesome	JJ
veracity	NN
verbalize	VB
verbatim	JJ
verbatim	RB
verbiage	NN
verbose	NN
verdant	NN
verge	NN
verge	VB
verisimilitude	NN
verity	NN
vernacular	JJ
vernacular	NN
versatile	JJ
vertex	NN
vertigo	NN
verve	NN
vestige	NN
vex	VB
viable	JJ
vicarious	JJ
vicissitude	NN
vie	NN
vigilance	NN
vignette	NN
vigor	NN
vilify	VB
vindicate	VB
vindictive	JJ
viper	NN
virile	JJ
virtual	JJ
virtue	NN
virtuoso	JJ
virulent	JJ
virus	NN
visceral	JJ
viscid	NN
viscous	JJ
vise	NN
visionary	NN
visionary	JJ
vital	JJ
vitriolic	JJ
vituperative	JJ
vivacious	JJ
vociferous	JJ
vogue	NN
volatile	JJ
volition	NN
voluble	JJ
voluminous	JJ
voluptuous	JJ
voracious	JJ
vortex	NN
vouchsafe	NN
voyeur	NN
vulnerable	JJ
waffle	NN
waft	NN
waggish	JJ
waif	NN
waive	VB
wake	NN
wallow	VB
wan	NN
wane	VB
wanton	NN
warble	NN
warble	VB
warrant	NN
warranty	NN
wary	JJ
wastrel	NN
watershed	NN
wax	NN
waylay	VB
wean	VB
weather	NN
welter	NN
wheedle	VB
whelp	NN
whet	VB
whiff	NN
whimsical	JJ
whinny	NN
whittle	NN
willful	JJ
wily	JJ
wince	NN
windfall	NN
winnow	NN
winsome	JJ
wispy	JJ
wistful	JJ
withdrawn	VBN
wither	VB
withhold	VB
withstand	VB
witless	JJ
witticism	NN
wizardry	NN
woe	NN
worldly	RB
wrath	NN
wrench	NN
writhe	VB
wry	NN
xenophobia	NN
yen	NN
yield	NN
yield	VB
yoke	NN
yoke	VB
yore	NN
zany	NN
zeal	NN
zealot	NN
zenith	NN
zephyr	NN
