abandoned 	 JJ
abandon 	 VB
ability 	 NN
able 	 JJ
about 	 ADVB
about 	 PREP
above 	 ADVB
above 	 PREP
abroad 	 ADVB
absence 	 NN
absent 	 JJ
absolute 	 JJ
absolutely 	 ADVB
absorb 	 VB
abuse 	 NN
abuse 	 VB
academic 	 JJ
accent 	 NN
acceptable 	 JJ
accept 	 VB
access 	 NN
accidental 	 JJ
accidentally 	 ADVB
accident 	 NN
accompany 	 VB
according 	 PREP
account 	 NN
account 	 VB
accurate 	 JJ
accurately 	 ADVB
accuse 	 VB
achievement 	 NN
achieve 	 VB
acid 	 NN
acknowledge 	 VB
acquire 	 VB
across 	 ADVB
across 	 PREP
action 	 NN
active 	 JJ
actively 	 ADVB
activist 	 NN
activity 	 NN
act 	 NN
actor 	 NN
actress 	 NN
actual 	 JJ
actually 	 ADVB
act 	 VB
adapt 	 VB
additional 	 JJ
addition 	 NN
address 	 NN
address 	 VB
add 	 VB
adequate 	 JJ
adequately 	 ADVB
adjust 	 VB
administration 	 NN
admiration 	 NN
admire 	 VB
admit 	 VB
ad 	 NN
adopt 	 VB
adult 	 JJ
adult 	 NN
advanced 	 JJ
advance 	 NN
advance 	 VB
advantage 	 NN
adventure 	 NN
advertisement 	 NN
advertise 	 VB
advertising 	 NN
advice 	 NN
advise 	 VB
affair 	 NN
affection 	 NN
affect 	 VB
afford 	 VB
afraid 	 JJ
after 	 ADVB
after 	 CONJ
afternoon 	 NN
after 	 PREP
afterward 	 ADVB
afterwards 	 ADVB
again 	 ADVB
against 	 PREP
aged 	 JJ
agency 	 NN
agenda 	 NN
age 	 NN
agent 	 NN
aggressive 	 JJ
ago 	 ADVB
agreement 	 NN
agree 	 VB
ahead 	 ADVB
aid 	 NN
aid 	 VB
aim 	 NN
aim 	 VB
a 	 INDEFART
aircraft 	 NN
air 	 NN
airport 	 NN
alarmed 	 JJ
alarming 	 JJ
alarm 	 NN
alarm 	 VB
alcoholic 	 JJ
alcohol 	 NN
alive 	 JJ
all 	 ADVB
all 	 DET
allied 	 JJ
allow 	 VB
all 	 PRNOUN
ally 	 NN
ally 	 VB
almost 	 ADVB
alone 	 JJ
alone 	 ADVB
along 	 ADVB
along 	 PREP
alongside 	 ADVB
alongside 	 PREP
aloud 	 ADVB
alphabetical 	 JJ
alphabetically 	 ADVB
alphabet 	 NN
already 	 ADVB
also 	 ADVB
alternative 	 JJ
alternatively 	 ADVB
alternative 	 NN
alter 	 VB
although 	 CONJ
altogether 	 ADVB
always 	 ADVB
a.m. 	 ABBR
amazed 	 JJ
amaze 	 VB
amazing 	 JJ
ambition 	 NN
ambulance 	 NN
among 	 PREP
amount 	 NN
amount 	 VB
amused 	 JJ
amuse 	 VB
amusing 	 JJ
analysis 	 NN
analyze 	 VB
ancient 	 JJ
and 	 CONJ
anger 	 NN
angle 	 NN
angrily 	 ADVB
angry 	 JJ
animal 	 NN
an 	 INDEFART
ankle 	 NN
anniversary 	 NN
announcement 	 NN
announce 	 VB
annoyed 	 JJ
annoying 	 JJ
annoy 	 VB
annual 	 JJ
annually 	 ADVB
another 	 DET
another 	 PRNOUN
answer 	 NN
answer 	 VB
anticipate 	 VB
anxiety 	 NN
anxious 	 JJ
anxiously 	 ADVB
any 	 ADVB
anybody 	 PRNOUN
any 	 DET
anyone 	 PRNOUN
any 	 PRNOUN
anything 	 PRNOUN
anyway 	 ADVB
anywhere 	 ADVB
apart 	 ADVB
apartment 	 NN
apologize 	 VB
apparent 	 JJ
apparently 	 ADVB
appeal 	 NN
appeal 	 VB
appearance 	 NN
appear 	 VB
apple 	 NN
application 	 NN
apply 	 VB
appointment 	 NN
appoint 	 VB
appreciate 	 VB
approach 	 NN
approach 	 VB
appropriate 	 JJ
approval 	 NN
approve 	 VB
approving 	 JJ
approximate 	 JJ
approximately 	 ADVB
April 	 NN
area 	 NN
argue 	 VB
argument 	 NN
arise 	 VB
armed 	 JJ
arm 	 NN
arms 	 NN
arm 	 VB
army 	 NN
around 	 ADVB
around 	 PREP
arrangement 	 NN
arrange 	 VB
arrest 	 NN
arrest 	 VB
arrival 	 NN
arrive 	 VB
arrow 	 NN
article 	 NN
artificial 	 JJ
artificially 	 ADVB
artistic 	 JJ
artist 	 NN
art 	 NN
as 	 ADVB
as 	 CONJ
ashamed 	 JJ
aside 	 ADVB
ask 	 VB
asleep 	 JJ
aspect 	 NN
as 	 PREP
assistance 	 NN
assistant 	 JJ
assistant 	 NN
assist 	 VB
associate 	 VB
association 	 NN
assume 	 VB
assure 	 VB
atmosphere 	 NN
atom 	 NN
at 	 PREP
attached 	 JJ
attach 	 VB
attack 	 NN
attack 	 VB
attempted 	 JJ
attempt 	 NN
attempt 	 VB
attend 	 VB
attention 	 NN
attitude 	 NN
attorney 	 NN
attraction 	 NN
attractive 	 JJ
attract 	 VB
audience 	 NN
August 	 NN
aunt 	 NN
authority 	 NN
author 	 NN
automatic 	 JJ
automatically 	 ADVB
available 	 JJ
average 	 JJ
average 	 NN
avoid 	 VB
awake 	 JJ
award 	 NN
award 	 VB
aware 	 JJ
away 	 ADVB
awful 	 JJ
awkward 	 JJ
awkwardly 	 ADVB
baby 	 NN
back 	 JJ
back 	 ADVB
background 	 NN
back 	 NN
back 	 VB
backward 	 JJ
backward 	 ADVB
backwards 	 ADVB
bacteria 	 NN
bad 	 JJ
badly 	 ADVB
baggage 	 NN
bag 	 NN
bake 	 VB
balance 	 NN
balance 	 VB
ball 	 NN
bandage 	 NN
bandage 	 VB
band 	 NN
bank 	 NN
ban 	 NN
ban 	 VB
barely 	 ADVB
bargain 	 NN
bar 	 NN
barrier 	 NN
baseball 	 NN
base 	 NN
base 	 VB
basic 	 JJ
basically 	 ADVB
basis 	 NN
basketball 	 NN
bath 	 NN
bathroom 	 NN
battery 	 NN
battle 	 NN
bay 	 NN
beach 	 NN
beak 	 NN
beard 	 NN
bear 	 VB
beat 	 NN
beat 	 VB
beautiful 	 JJ
beautifully 	 ADVB
beauty 	 NN
be 	 AUX
because 	 CONJ
because 	 PREP
become 	 VB
bed 	 NN
bedroom 	 NN
beef 	 NN
beer 	 NN
before 	 ADVB
before 	 CONJ
before 	 PREP
beginning 	 NN
begin 	 VB
behalf 	 NN
behave 	 VB
behavior 	 NN
behind 	 ADVB
behind 	 PREP
belief 	 NN
believe 	 VB
bell 	 NN
belong 	 VB
below 	 ADVB
below 	 PREP
belt 	 NN
bend 	 NN
bend 	 VB
beneath 	 ADVB
beneath 	 PREP
benefit 	 NN
benefit 	 VB
bent 	 JJ
beside 	 PREP
best 	 ADVB
bet 	 NN
better 	 ADVB
bet 	 VB
between 	 ADVB
between 	 PREP
be 	 VB
beyond 	 ADVB
beyond 	 PREP
bicycle 	 NN
bid 	 NN
bid 	 VB
big 	 JJ
bike 	 NN
bill 	 NN
biology 	 NN
bird 	 NN
birthday 	 NN
birth 	 NN
bite 	 NN
bite 	 VB
bit 	 NN
bitter 	 JJ
bitterly 	 ADVB
black 	 JJ
black 	 NN
blade 	 NN
blame 	 NN
blame 	 VB
blank 	 JJ
blankly 	 ADVB
blank 	 NN
blind 	 JJ
block 	 NN
block 	 VB
blond 	 JJ
blonde 	 JJ
blonde 	 NN
blond 	 NN
blood 	 NN
blow 	 NN
blow 	 VB
blue 	 JJ
blue 	 NN
board 	 NN
board 	 VB
boat 	 NN
body 	 NN
boil 	 VB
bomb 	 NN
bomb 	 VB
bond 	 NN
bone 	 NN
book 	 NN
book 	 VB
boot 	 NN
border 	 NN
bored 	 JJ
bore 	 VB
boring 	 JJ
born 	 VB
borrow 	 VB
boss 	 NN
both 	 DET
bother 	 VB
both 	 PRNOUN
bottle 	 NN
bottom 	 JJ
bottom 	 NN
bound 	 JJ
bowl 	 NN
box 	 NN
boyfriend 	 NN
boy 	 NN
brain 	 NN
branch 	 NN
brand 	 NN
brave 	 JJ
bread 	 NN
breakfast 	 NN
break 	 NN
break 	 VB
breast 	 NN
breathe 	 VB
breathing 	 NN
breath 	 NN
breed 	 NN
breed 	 VB
brick 	 NN
bridge 	 NN
brief 	 JJ
briefly 	 ADVB
bright 	 JJ
brightly 	 ADVB
brilliant 	 JJ
bring 	 VB
broad 	 JJ
broadcast 	 NN
broadcast 	 VB
broadly 	 ADVB
broken 	 JJ
brother 	 NN
brown 	 JJ
brown 	 NN
brush 	 NN
brush 	 VB
bubble 	 NN
budget 	 NN
building 	 NN
build 	 VB
bullet 	 NN
bunch 	 NN
burn 	 VB
burst 	 VB
bury 	 VB
bush 	 NN
businessman 	 NN
business 	 NN
businesswoman 	 NN
bus 	 NN
busy 	 JJ
but 	 CONJ
butter 	 NN
butt 	 NN
button 	 NN
buyer 	 NN
buy 	 VB
by 	 ADVB
bye 	 EXCLAM
by 	 PREP
c 	 ABBR
cabinet 	 NN
cable 	 NN
cake 	 NN
calculate 	 VB
calculation 	 NN
call 	 NN
call 	 VB
calm 	 JJ
calmly 	 ADVB
calm 	 NN
calm 	 VB
camera 	 NN
campaign 	 NN
camp 	 NN
camp 	 VB
cancel 	 VB
cancer 	 NN
candidate 	 NN
candy 	 NN
can 	 MODAL
can 	 NN
capable 	 JJ
capacity 	 NN
capital 	 JJ
capital 	 NN
cap 	 NN
captain 	 NN
capture 	 NN
capture 	 VB
card 	 NN
career 	 NN
careful 	 JJ
carefully 	 ADVB
careless 	 JJ
carelessly 	 ADVB
care 	 NN
care 	 VB
car 	 NN
carpet 	 NN
carrot 	 NN
carry 	 VB
case 	 NN
cash 	 NN
castle 	 NN
cast 	 NN
cast 	 VB
catch 	 VB
category 	 NN
cat 	 NN
cause 	 NN
cause 	 VB
CD 	 NN
cease 	 VB
ceiling 	 NN
celebrate 	 VB
celebration 	 NN
cell 	 NN
cellphone 	 NN
cellular 	 JJ
cent 	 ABBR
center 	 NN
centimeter 	 NN
cent 	 NN
central 	 JJ
century 	 NN
ceremony 	 NN
certain 	 JJ
certainly 	 ADVB
certain 	 PRNOUN
certificate 	 NN
chain 	 NN
chain 	 VB
chairman 	 NN
chair 	 NN
chairwoman 	 NN
challenge 	 NN
challenge 	 VB
chamber 	 NN
chance 	 NN
change 	 NN
change 	 VB
channel 	 NN
chapter 	 NN
characteristic 	 JJ
characteristic 	 NN
character 	 NN
charge 	 NN
charge 	 VB
charity 	 NN
chart 	 NN
chart 	 VB
chase 	 NN
chase 	 VB
chat 	 NN
chat 	 VB
cheap 	 JJ
cheaply 	 ADVB
cheat 	 NN
cheat 	 VB
check 	 NN
check 	 VB
cheek 	 NN
cheerful 	 JJ
cheerfully 	 ADVB
cheese 	 NN
chemical 	 JJ
chemical 	 NN
chemist 	 NN
chemistry 	 NN
chest 	 NN
chew 	 VB
chicken 	 NN
chief 	 JJ
chief 	 NN
childhood 	 NN
child 	 NN
chin 	 NN
chip 	 NN
chocolate 	 NN
choice 	 NN
choose 	 VB
chop 	 VB
church 	 NN
cigarette 	 NN
circle 	 NN
circumstance 	 NN
citizen 	 NN
city 	 NN
civil 	 JJ
claim 	 NN
claim 	 VB
classic 	 JJ
classic 	 NN
class 	 NN
classroom 	 NN
clean 	 JJ
clean 	 VB
clear 	 JJ
clearly 	 ADVB
clear 	 VB
clerk 	 NN
click 	 NN
click 	 VB
client 	 NN
climate 	 NN
climb 	 VB
clock 	 NN
close 	 JJ
closed 	 JJ
closely 	 ADVB
closet 	 NN
close 	 VB
clothes 	 NN
clothing 	 NN
cloth 	 NN
cloud 	 NN
club 	 NN
cm 	 ABBR
coach 	 NN
coal 	 NN
coast 	 NN
coat 	 NN
code 	 NN
coffee 	 NN
coin 	 NN
cold 	 JJ
coldly 	 ADVB
cold 	 NN
collapse 	 NN
collapse 	 VB
colleague 	 NN
collection 	 NN
collect 	 VB
college 	 NN
colored 	 JJ
color 	 NN
color 	 VB
column 	 NN
combination 	 NN
combine 	 VB
comedy 	 NN
come 	 VB
comfortable 	 JJ
comfortably 	 ADVB
comfort 	 NN
comfort 	 VB
command 	 NN
command 	 VB
comment 	 NN
comment 	 VB
commercial 	 JJ
commercial 	 NN
commission 	 NN
commission 	 VB
commitment 	 NN
committee 	 NN
commit 	 VB
common 	 JJ
commonly 	 ADVB
communicate 	 VB
communication 	 NN
community 	 NN
company 	 NN
compare 	 VB
comparison 	 NN
compete 	 VB
competition 	 NN
competitive 	 JJ
complaint 	 NN
complain 	 VB
complete 	 JJ
completely 	 ADVB
complete 	 VB
complex 	 JJ
complicated 	 JJ
complicate 	 VB
component 	 NN
computer 	 NN
concentrate 	 VB
concentration 	 NN
concept 	 NN
concerned 	 JJ
concerning 	 PREP
concern 	 NN
concern 	 VB
concert 	 NN
conclude 	 VB
conclusion 	 NN
concrete 	 JJ
concrete 	 NN
condition 	 NN
conduct 	 NN
conduct 	 VB
conference 	 NN
confidence 	 NN
confident 	 JJ
confidently 	 ADVB
confirm 	 VB
conflict 	 NN
conflict 	 VB
confront 	 VB
confused 	 JJ
confuse 	 VB
confusing 	 JJ
confusion 	 NN
congratulations 	 NN
congress 	 NN
connection 	 NN
connect 	 VB
conscious 	 JJ
consequence 	 NN
conservative 	 JJ
considerable 	 JJ
considerably 	 ADVB
consideration 	 NN
consider 	 VB
consistent 	 JJ
consist 	 VB
constant 	 JJ
constantly 	 ADVB
construction 	 NN
construct 	 VB
consult 	 VB
consumer 	 NN
contact 	 NN
contact 	 VB
container 	 NN
contain 	 VB
contemporary 	 JJ
content 	 NN
contest 	 NN
context 	 NN
continent 	 NN
continue 	 VB
continuous 	 JJ
continuously 	 ADVB
contract 	 NN
contract 	 VB
contrasting 	 JJ
contrast 	 NN
contrast 	 VB
contribute 	 VB
contribution 	 NN
controlled 	 JJ
control 	 NN
control 	 VB
convenient 	 JJ
conventional 	 JJ
convention 	 NN
conversation 	 NN
convert 	 VB
convince 	 VB
cookie 	 NN
cooking 	 NN
cook 	 NN
cook 	 VB
cool 	 JJ
cool 	 VB
cooperation 	 NN
copy 	 NN
copy 	 VB
core 	 NN
corner 	 NN
correct 	 JJ
correctly 	 ADVB
correct 	 VB
cost 	 NN
cost 	 VB
cottage 	 NN
cotton 	 NN
cough 	 NN
cough 	 VB
could 	 MODAL
council 	 NN
counter 	 NN
country 	 NN
countryside 	 NN
count 	 VB
county 	 NN
couple 	 NN
courage 	 NN
course 	 NN
court 	 NN
cousin 	 NN
covered 	 JJ
covering 	 NN
cover 	 NN
cover 	 VB
cow 	 NN
cracked 	 JJ
crack 	 NN
crack 	 VB
craft 	 NN
crash 	 NN
crash 	 VB
crazy 	 JJ
cream 	 JJ
cream 	 NN
create 	 VB
creation 	 NN
creative 	 JJ
creature 	 NN
creditcard 	 NN
credit 	 NN
crime 	 NN
criminal 	 JJ
criminal 	 NN
crisis 	 NN
crisp 	 JJ
criterion 	 NN
critical 	 JJ
criticism 	 NN
criticize 	 VB
critic 	 NN
crop 	 NN
cross 	 NN
cross 	 VB
crowded 	 JJ
crowd 	 NN
crown 	 NN
crucial 	 JJ
cruel 	 JJ
crush 	 VB
cry 	 NN
cry 	 VB
cultural 	 JJ
culture 	 NN
cupboard 	 NN
cup 	 NN
cure 	 NN
cure 	 VB
curious 	 JJ
curiously 	 ADVB
curl 	 NN
curl 	 VB
curly 	 JJ
current 	 JJ
currently 	 ADVB
current 	 NN
curtain 	 NN
curved 	 JJ
curve 	 NN
curve 	 VB
customer 	 NN
custom 	 NN
customs 	 NN
cute 	 JJ
cut 	 NN
cut 	 VB
cycle 	 NN
cycle 	 VB
cycling 	 NN
dad 	 NN
daily 	 JJ
damage 	 NN
damage 	 VB
damp 	 JJ
dance 	 NN
dancer 	 NN
dance 	 VB
dancing 	 NN
danger 	 NN
dangerous 	 JJ
dare 	 VB
dark 	 JJ
dark 	 NN
data 	 NN
date 	 NN
date 	 VB
daughter 	 NN
day 	 NN
dead 	 JJ
deaf 	 JJ
deal 	 NN
deal 	 VB
dear 	 JJ
death 	 NN
debate 	 NN
debate 	 VB
debt 	 NN
decade 	 NN
decay 	 NN
decay 	 VB
December 	 NN
decent 	 JJ
decide 	 VB
decision 	 NN
declare 	 VB
decline 	 NN
decline 	 VB
decorate 	 VB
decoration 	 NN
decorative 	 JJ
decrease 	 NN
decrease 	 VB
deep 	 JJ
deeply 	 ADVB
defeat 	 NN
defeat 	 VB
defend 	 VB
defense 	 NN
define 	 VB
definite 	 JJ
definitely 	 ADVB
definition 	 NN
degree 	 NN
delay 	 NN
delay 	 VB
deliberate 	 JJ
deliberately 	 ADVB
delicate 	 JJ
delight 	 NN
delight 	 VB
deliver 	 VB
delivery 	 NN
demand 	 NN
demand 	 VB
democracy 	 NN
democratic 	 JJ
demonstrate 	 VB
demonstration 	 NN
dentist 	 NN
deny 	 VB
department 	 NN
departure 	 NN
depend 	 VB
deposit 	 NN
deposit 	 VB
depressed 	 JJ
depressing 	 JJ
depress 	 VB
depth 	 NN
derive 	 VB
describe 	 VB
description 	 NN
desert 	 NN
desert 	 VB
deserve 	 VB
designer 	 NN
design 	 NN
design 	 VB
desire 	 NN
desire 	 VB
desk 	 NN
desperate 	 JJ
desperately 	 ADVB
despite 	 PREP
destroy 	 VB
destruction 	 NN
detailed 	 JJ
detail 	 NN
determination 	 NN
determined 	 JJ
determine 	 VB
development 	 NN
develop 	 VB
device 	 NN
devoted 	 JJ
devote 	 VB
diagram 	 NN
dialog 	 NN
dialogue 	 NN
diamond 	 NN
diary 	 NN
dictionary 	 NN
diet 	 NN
die 	 VB
difference 	 NN
different 	 JJ
differently 	 ADVB
difficult 	 JJ
difficulty 	 NN
digital 	 JJ
dig 	 VB
dinner 	 NN
direct 	 JJ
direction 	 NN
directly 	 ADVB
director 	 NN
direct 	 VB
dirt 	 NN
dirty 	 JJ
disability 	 NN
disadvantage 	 NN
disagreement 	 NN
disagree 	 VB
disappear 	 VB
disappointed 	 JJ
disappointing 	 JJ
disappointment 	 NN
disappoint 	 VB
disapproval 	 NN
disapprove 	 VB
disapproving 	 JJ
disaster 	 NN
discipline 	 NN
disc 	 NN
discount 	 NN
discover 	 VB
discovery 	 NN
discussion 	 NN
discuss 	 VB
disease 	 NN
disgusted 	 JJ
disgusting 	 JJ
disgust 	 NN
disgust 	 VB
dish 	 NN
dishonest 	 JJ
dishonestly 	 ADVB
disk 	 NN
dislike 	 NN
dislike 	 VB
dismiss 	 VB
display 	 NN
display 	 VB
dissolve 	 VB
distance 	 NN
distant 	 JJ
distinguish 	 VB
distribute 	 VB
distribution 	 NN
district 	 NN
disturbing 	 JJ
disturb 	 VB
divide 	 VB
division 	 NN
divorced 	 JJ
divorce 	 NN
divorce 	 VB
do 	 AUX
doctor 	 NN
document 	 NN
dog 	 NN
dollar 	 NN
domestic 	 JJ
dominate 	 VB
door 	 NN
dot 	 NN
double 	 JJ
double 	 ADVB
double 	 DET
double 	 NN
double 	 VB
doubt 	 NN
doubt 	 VB
do 	 VB
down 	 ADVB
down 	 PREP
downstairs 	 JJ
downstairs 	 ADVB
downstairs 	 NN
downtown 	 JJ
downtown 	 ADVB
downward 	 JJ
downward 	 ADVB
downwards 	 ADVB
dozen 	 DET
dozen 	 NN
draft 	 JJ
draft 	 NN
draft 	 VB
drag 	 VB
drama 	 NN
dramatic 	 JJ
dramatically 	 ADVB
drawer 	 NN
drawing 	 NN
draw 	 VB
dream 	 NN
dream 	 VB
dressed 	 JJ
dress 	 NN
dress 	 VB
drink 	 NN
drink 	 VB
drive 	 NN
driver 	 NN
drive 	 VB
driving 	 NN
drop 	 NN
drop 	 VB
drug 	 NN
drugstore 	 NN
drum 	 NN
drunk 	 JJ
dry 	 JJ
dry 	 VB
due 	 JJ
dull 	 JJ
dump 	 NN
dump 	 VB
during 	 PREP
dust 	 NN
dust 	 VB
duty 	 NN
DVD 	 NN
dying 	 JJ
each 	 DET
each 	 PRNOUN
eager 	 JJ
early 	 JJ
early 	 ADVB
ear 	 NN
earn 	 VB
earth 	 NN
ease 	 NN
ease 	 VB
easily 	 ADVB
east 	 JJ
east 	 ADVB
eastern 	 JJ
east 	 NN
easy 	 JJ
eat 	 VB
economic 	 JJ
economics 	 NN
economy 	 NN
edge 	 NN
edition 	 NN
editor 	 NN
educated 	 JJ
educate 	 VB
educational 	 JJ
education 	 NN
effective 	 JJ
effectively 	 ADVB
effect 	 NN
efficient 	 JJ
efficiently 	 ADVB
effort 	 NN
e.g. 	 ABBR
egg 	 NN
either 	 ADVB
either 	 DET
either 	 PRNOUN
elbow 	 NN
elderly 	 JJ
election 	 NN
electric 	 JJ
electrical 	 JJ
electricity 	 NN
electronic 	 JJ
elect 	 VB
elegant 	 JJ
element 	 NN
elevator 	 NN
eliminate 	 VB
else 	 ADVB
elsewhere 	 ADVB
e-mail 	 NN
email 	 NN
e-mail 	 VB
email 	 VB
embarrassed 	 JJ
embarrassing 	 JJ
embarrassment 	 NN
embarrass 	 VB
emergency 	 NN
emerge 	 VB
emotional 	 JJ
emotionally 	 ADVB
emotion 	 NN
emphasis 	 NN
emphasize 	 VB
empire 	 NN
employee 	 NN
employer 	 NN
employment 	 NN
employ 	 VB
empty 	 JJ
empty 	 VB
enable 	 VB
encounter 	 NN
encounter 	 VB
encouragement 	 NN
encourage 	 VB
ending 	 NN
end 	 NN
end 	 VB
enemy 	 NN
energy 	 NN
engaged 	 JJ
engage 	 VB
engineering 	 NN
engineer 	 NN
engine 	 NN
enjoyable 	 JJ
enjoyment 	 NN
enjoy 	 VB
enormous 	 JJ
enough 	 ADVB
enough 	 DET
enough 	 PRNOUN
ensure 	 VB
entertainer 	 NN
entertaining 	 JJ
entertainment 	 NN
entertain 	 VB
enter 	 VB
enthusiasm 	 NN
enthusiastic 	 JJ
entire 	 JJ
entirely 	 ADVB
entitle 	 VB
entrance 	 NN
entry 	 NN
envelope 	 NN
environmental 	 JJ
environment 	 NN
equal 	 JJ
equally 	 ADVB
equal 	 NN
equal 	 VB
equipment 	 NN
equivalent 	 JJ
equivalent 	 NN
era 	 NN
error 	 NN
escape 	 NN
escape 	 VB
especially 	 ADVB
essay 	 NN
essential 	 JJ
essentially 	 ADVB
essential 	 NN
establish 	 VB
estate 	 NN
estimate 	 NN
estimate 	 VB
etc. 	 ADVB
ethnic 	 JJ
even 	 JJ
even 	 ADVB
evening 	 NN
event 	 NN
eventually 	 ADVB
ever 	 ADVB
everybody 	 PRNOUN
every 	 DET
everyone 	 PRNOUN
everything 	 PRNOUN
everywhere 	 ADVB
evidence 	 NN
evil 	 JJ
evil 	 NN
exact 	 JJ
exactly 	 ADVB
exaggerated 	 JJ
exaggerate 	 VB
examination 	 NN
examine 	 VB
exam 	 NN
example 	 NN
excellent 	 JJ
except 	 CONJ
exception 	 NN
except 	 PREP
exchange 	 NN
exchange 	 VB
excited 	 JJ
excitement 	 NN
excite 	 VB
exciting 	 JJ
exclude 	 VB
excluding 	 PREP
excuse 	 NN
excuse 	 VB
executive 	 JJ
executive 	 NN
exercise 	 NN
exercise 	 VB
exhibition 	 NN
exhibit 	 NN
exhibit 	 VB
existence 	 NN
exist 	 VB
exit 	 NN
expand 	 VB
expectation 	 NN
expected 	 JJ
expect 	 VB
expense 	 NN
expensive 	 JJ
experienced 	 JJ
experience 	 NN
experience 	 VB
experiment 	 NN
experiment 	 VB
expert 	 JJ
expert 	 NN
explain 	 VB
explanation 	 NN
explode 	 VB
explore 	 VB
explosion 	 NN
export 	 NN
export 	 VB
expose 	 VB
express 	 JJ
expression 	 NN
express 	 VB
extend 	 VB
extension 	 NN
extensive 	 JJ
extent 	 NN
extra 	 JJ
extra 	 ADVB
extra 	 NN
extraordinary 	 JJ
extreme 	 JJ
extremely 	 ADVB
extreme 	 NN
eye 	 NN
face 	 NN
face 	 VB
facility 	 NN
fact 	 NN
factor 	 NN
factory 	 NN
failure 	 NN
fail 	 VB
faint 	 JJ
faintly 	 ADVB
fair 	 JJ
fairly 	 ADVB
faithful 	 JJ
faithfully 	 ADVB
faith 	 NN
fall 	 NN
fall 	 VB
false 	 JJ
fame 	 NN
familiar 	 JJ
family 	 JJ
family 	 NN
famous 	 JJ
fancy 	 JJ
fan 	 NN
far 	 JJ
far 	 ADVB
farmer 	 NN
farming 	 NN
farm 	 NN
farther 	 JJ
farther 	 ADVB
farthest 	 JJ
farthest 	 ADVB
fashionable 	 JJ
fashion 	 NN
fast 	 JJ
fast 	 ADVB
fasten 	 VB
fat 	 JJ
father 	 NN
fat 	 NN
fault 	 NN
favorite 	 JJ
favorite 	 NN
favor 	 NN
fear 	 NN
fear 	 VB
feather 	 NN
feature 	 NN
feature 	 VB
February 	 NN
federal 	 JJ
feed 	 VB
feeling 	 NN
feel 	 VB
fee 	 NN
fellow 	 JJ
fellow 	 NN
female 	 JJ
female 	 NN
fence 	 NN
festival 	 NN
fever 	 NN
few 	 JJ
few 	 DET
few 	 PRNOUN
field 	 NN
fighting 	 NN
fight 	 NN
fight 	 VB
figure 	 NN
figure 	 VB
file 	 NN
fill 	 VB
film 	 NN
film 	 VB
final 	 JJ
finally 	 ADVB
final 	 NN
finance 	 NN
finance 	 VB
financial 	 JJ
find 	 VB
fine 	 JJ
finely 	 ADVB
finger 	 NN
finished 	 JJ
finish 	 NN
finish 	 VB
fire 	 NN
fire 	 VB
firm 	 JJ
firm 	 ADVB
firmly 	 ADVB
firm 	 NN
first 	 DET
first 	 ORD
fishing 	 NN
fish 	 NN
fish 	 VB
fit 	 JJ
fit 	 VB
fixed 	 JJ
fix 	 VB
flag 	 NN
flame 	 NN
flash 	 NN
flash 	 VB
flat 	 JJ
flavor 	 NN
flavor 	 VB
flesh 	 NN
flight 	 NN
float 	 VB
flood 	 NN
flood 	 VB
floor 	 NN
flour 	 NN
flower 	 NN
flow 	 NN
flow 	 VB
flu 	 NN
flying 	 JJ
flying 	 NN
fly 	 NN
fly 	 VB
focus 	 NN
focus 	 VB
folding 	 JJ
fold 	 NN
fold 	 VB
folk 	 NN
following 	 JJ
following 	 NN
following 	 PREP
follow 	 VB
food 	 NN
football 	 NN
foot 	 NN
force 	 NN
force 	 VB
forecast 	 NN
forecast 	 VB
foreign 	 JJ
forest 	 NN
forever 	 ADVB
forget 	 VB
forgive 	 VB
fork 	 NN
formal 	 JJ
formally 	 ADVB
former 	 JJ
formerly 	 ADVB
former 	 NN
form 	 NN
formula 	 NN
form 	 VB
for 	 PREP
fortune 	 NN
forward 	 JJ
forward 	 ADVB
forwards 	 ADVB
foundation 	 NN
found 	 VB
frame 	 NN
frame 	 VB
free 	 JJ
free 	 ADVB
freedom 	 NN
freely 	 ADVB
free 	 VB
freeze 	 VB
frequent 	 JJ
frequently 	 ADVB
fresh 	 JJ
freshly 	 ADVB
Friday 	 NN
friendly 	 JJ
friend 	 NN
friendship 	 NN
frightened 	 JJ
frightening 	 JJ
frighten 	 VB
from 	 PREP
front 	 JJ
front 	 NN
frozen 	 JJ
fruit 	 NN
fry 	 VB
fuel 	 NN
full 	 JJ
fully 	 ADVB
fun 	 JJ
function 	 NN
function 	 VB
fundamental 	 JJ
fund 	 NN
fund 	 VB
funeral 	 NN
fun 	 NN
funny 	 JJ
furniture 	 NN
fur 	 NN
further 	 JJ
furthest 	 JJ
future 	 JJ
future 	 NN
gain 	 NN
gain 	 VB
gallon 	 NN
gamble 	 NN
gamble 	 VB
gambling 	 NN
game 	 NN
gap 	 NN
garage 	 NN
garbage 	 NN
garden 	 NN
gas 	 NN
gasoline 	 NN
gate 	 NN
gather 	 VB
gay 	 JJ
gear 	 NN
gene 	 NN
general 	 JJ
generally 	 ADVB
generate 	 VB
generation 	 NN
generous 	 JJ
generously 	 ADVB
gentle 	 JJ
gentleman 	 NN
gently 	 ADVB
genuine 	 JJ
genuinely 	 ADVB
geography 	 NN
get 	 VB
giant 	 JJ
giant 	 NN
gift 	 NN
girlfriend 	 NN
girl 	 NN
give 	 VB
glad 	 JJ
glasses 	 NN
glass 	 NN
global 	 JJ
glove 	 NN
glue 	 NN
glue 	 VB
goal 	 NN
god 	 NN
gold 	 JJ
gold 	 NN
good 	 JJ
goodbye 	 EXCLAM
goodbye 	 NN
good 	 NN
goods 	 NN
go 	 VB
government 	 NN
governor 	 NN
govern 	 VB
grab 	 VB
grade 	 NN
grade 	 VB
gradual 	 JJ
gradually 	 ADVB
graduate 	 NN
graduate 	 VB
grain 	 NN
grammar 	 NN
grand 	 JJ
grandchild 	 NN
granddaughter 	 NN
grandfather 	 NN
grandmother 	 NN
grandparent 	 NN
grandson 	 NN
grant 	 NN
grant 	 VB
grass 	 NN
grateful 	 JJ
grave 	 JJ
grave 	 NN
gray 	 JJ
gray 	 NN
great 	 JJ
greatly 	 ADVB
green 	 JJ
green 	 NN
groceries 	 NN
grocery 	 JJ
ground 	 NN
group 	 NN
growth 	 NN
grow 	 VB
guarantee 	 NN
guarantee 	 VB
guard 	 NN
guard 	 VB
guess 	 NN
guess 	 VB
guest 	 NN
guide 	 NN
guide 	 VB
guilty 	 JJ
guitar 	 NN
gun 	 NN
guy 	 NN
habit 	 NN
hairdresser 	 NN
hair 	 NN
half 	 ADVB
half 	 DET
half 	 NN
half 	 PRNOUN
hall 	 NN
hammer 	 NN
handle 	 NN
handle 	 VB
hand 	 NN
hand 	 VB
hang 	 VB
happen 	 VB
happily 	 ADVB
happiness 	 NN
happy 	 JJ
hard 	 JJ
hard 	 ADVB
hardly 	 ADVB
harmful 	 JJ
harmless 	 JJ
harm 	 NN
harm 	 VB
hate 	 NN
hate 	 VB
hat 	 NN
hatred 	 NN
have 	 AUX
have 	 VB
headache 	 NN
head 	 NN
head 	 VB
health 	 NN
healthy 	 JJ
heal 	 VB
hearing 	 NN
heart 	 NN
hear 	 VB
heating 	 NN
heat 	 NN
heat 	 VB
heaven 	 NN
heavily 	 ADVB
heavy 	 JJ
heel 	 NN
height 	 NN
hell 	 NN
hello 	 EXCLAM
hello 	 NN
helpful 	 JJ
help 	 NN
help 	 VB
he 	 PRNOUN
her 	 DET
here 	 ADVB
hero 	 NN
her 	 PRNOUN
herself 	 PRNOUN
hers 	 PRNOUN
hesitate 	 VB
hide 	 VB
hi 	 EXCLAM
high 	 JJ
high 	 ADVB
highlight 	 NN
highlight 	 VB
highly 	 ADVB
highschool 	 NN
highway 	 NN
hill 	 NN
him 	 PRNOUN
himself 	 PRNOUN
hip 	 NN
hire 	 VB
his 	 DET
his 	 PRNOUN
historical 	 JJ
history 	 NN
hit 	 NN
hit 	 VB
hobby 	 NN
hold 	 NN
hold 	 VB
hole 	 NN
holiday 	 NN
hollow 	 JJ
holy 	 JJ
home 	 ADVB
home 	 NN
homework 	 NN
honest 	 JJ
honestly 	 ADVB
honor 	 NN
hook 	 NN
hopefully 	 ADVB
hope 	 NN
hope 	 VB
horizontal 	 JJ
horn 	 NN
horror 	 NN
horse 	 NN
hospital 	 NN
host 	 NN
host 	 VB
hot 	 JJ
hotel 	 NN
hour 	 NN
household 	 JJ
household 	 NN
house 	 NN
housing 	 NN
how 	 ADVB
however 	 ADVB
huge 	 JJ
human 	 JJ
human 	 NN
humor 	 NN
humorous 	 JJ
hungry 	 JJ
hunting 	 NN
hunt 	 VB
hurry 	 NN
hurry 	 VB
hurt 	 VB
husband 	 NN
ice-cream 	 NN
ice 	 NN
ideal 	 JJ
ideally 	 ADVB
ideal 	 NN
idea 	 NN
identify 	 VB
identity 	 NN
i.e. 	 ABBR
if 	 CONJ
ignore 	 VB
ill 	 JJ
illegal 	 JJ
illegally 	 ADVB
illness 	 NN
illustrate 	 VB
image 	 NN
imaginary 	 JJ
imagination 	 NN
imagine 	 VB
immediate 	 JJ
immediately 	 ADVB
immoral 	 JJ
impact 	 NN
impatient 	 JJ
impatiently 	 ADVB
implication 	 NN
imply 	 VB
importance 	 NN
important 	 JJ
importantly 	 ADVB
import 	 NN
import 	 VB
impose 	 VB
impossible 	 JJ
impressed 	 JJ
impression 	 NN
impressive 	 JJ
impress 	 VB
improvement 	 NN
improve 	 VB
inability 	 NN
in 	 ADVB
inch 	 NN
incident 	 NN
include 	 VB
including 	 PREP
income 	 NN
increase 	 NN
increase 	 VB
increasingly 	 ADVB
indeed 	 ADVB
independence 	 NN
independent 	 JJ
independently 	 ADVB
index 	 NN
indicate 	 VB
indication 	 NN
indirect 	 JJ
indirectly 	 ADVB
individual 	 JJ
individual 	 NN
indoor 	 JJ
indoors 	 ADVB
industrial 	 JJ
industry 	 NN
inevitable 	 JJ
inevitably 	 ADVB
infected 	 JJ
infection 	 NN
infectious 	 JJ
infect 	 VB
influence 	 NN
influence 	 VB
informal 	 JJ
information 	 NN
inform 	 VB
ingredient 	 NN
initial 	 JJ
initially 	 ADVB
initial 	 NN
initiative 	 NN
injured 	 JJ
injure 	 VB
injury 	 NN
ink 	 NN
inner 	 JJ
innocent 	 JJ
in 	 PREP
inquiry 	 NN
insect 	 NN
insert 	 VB
inside 	 JJ
inside 	 ADVB
inside 	 NN
inside 	 PREP
insist 	 VB
install 	 VB
instance 	 NN
instead 	 ADVB
institute 	 NN
institution 	 NN
instruction 	 NN
instrument 	 NN
insulting 	 JJ
insult 	 NN
insult 	 VB
insurance 	 NN
intellectual 	 JJ
intelligence 	 NN
intelligent 	 JJ
intended 	 JJ
intend 	 VB
intense 	 JJ
intention 	 NN
interested 	 JJ
interesting 	 JJ
interest 	 NN
interest 	 VB
interior 	 JJ
interior 	 NN
internal 	 JJ
international 	 JJ
Internet 	 NN
interpretation 	 NN
interpret 	 VB
interruption 	 NN
interrupt 	 VB
interval 	 NN
interview 	 NN
interview 	 VB
into 	 PREP
introduce 	 VB
introduction 	 NN
invention 	 NN
invent 	 VB
investigate 	 VB
investigation 	 NN
investment 	 NN
invest 	 VB
invitation 	 NN
invite 	 VB
involvement 	 NN
involve 	 VB
I 	 PRNOUN
iron 	 NN
iron 	 VB
irritated 	 JJ
irritate 	 VB
irritating 	 JJ
island 	 NN
issue 	 NN
issue 	 VB
it 	 DET
item 	 NN
it 	 PRNOUN
its 	 DET
itself 	 PRNOUN
jacket 	 NN
jail 	 NN
January 	 NN
jealous 	 JJ
jeans 	 NN
jelly 	 NN
jewelry 	 NN
job 	 NN
joint 	 JJ
jointly 	 ADVB
joint 	 NN
join 	 VB
joke 	 NN
joke 	 VB
journalist 	 NN
journey 	 NN
joy 	 NN
judgement 	 NN
judge 	 NN
judge 	 VB
judgment 	 NN
juice 	 NN
July 	 NN
jump 	 NN
jump 	 VB
June 	 NN
junior 	 JJ
junior 	 NN
jury 	 NN
just 	 ADVB
justice 	 NN
justified 	 JJ
justify 	 VB
keen 	 JJ
keep 	 VB
key 	 JJ
keyboard 	 NN
key 	 NN
kick 	 NN
kick 	 VB
kid 	 NN
kid 	 VB
killing 	 NN
kill 	 VB
kilogram 	 NN
kilo 	 NN
kind 	 JJ
kindly 	 ADVB
kindness 	 NN
kind 	 NN
king 	 NN
kiss 	 NN
kiss 	 VB
kitchen 	 NN
knee 	 NN
knife 	 NN
knock 	 NN
knock 	 VB
knot 	 NN
knowledge 	 NN
know 	 VB
label 	 NN
label 	 VB
lab 	 NN
laboratory 	 NN
labor 	 NN
lacking 	 JJ
lack 	 NN
lack 	 VB
lady 	 NN
lake 	 NN
lamp 	 NN
land 	 NN
landscape 	 NN
land 	 VB
lane 	 NN
language 	 NN
large 	 JJ
largely 	 ADVB
last 	 ADVB
last 	 DET
last 	 NN
last 	 VB
late 	 JJ
late 	 ADVB
lately 	 ADVB
later 	 JJ
later 	 ADVB
latest 	 JJ
latest 	 NN
latter 	 JJ
latter 	 NN
laugh 	 NN
laugh 	 VB
launch 	 NN
launch 	 VB
laundry 	 NN
law 	 NN
lawyer 	 NN
layer 	 NN
lay 	 VB
lazy 	 JJ
leader 	 NN
leading 	 JJ
lead 	 NN
lead 	 VB
leaf 	 NN
league 	 NN
lean 	 VB
learn 	 VB
least 	 ADVB
least 	 DET
least 	 PRNOUN
leather 	 NN
leave 	 VB
lecture 	 NN
left 	 JJ
left 	 ADVB
left 	 NN
legal 	 JJ
legally 	 ADVB
leg 	 NN
lemon 	 NN
lend 	 VB
length 	 NN
less 	 ADVB
less 	 DET
lesson 	 NN
less 	 PRNOUN
letter 	 NN
let 	 VB
level 	 JJ
level 	 NN
liberal 	 JJ
library 	 NN
license 	 NN
license 	 VB
lid 	 NN
lie 	 NN
lie 	 VB
life 	 NN
lift 	 VB
light 	 JJ
lightly 	 ADVB
light 	 NN
light 	 VB
like 	 CONJ
likely 	 JJ
likely 	 ADVB
like 	 PREP
like 	 VB
limited 	 JJ
limit 	 NN
limit 	 VB
line 	 NN
link 	 NN
link 	 VB
lip 	 NN
liquid 	 JJ
liquid 	 NN
listen 	 VB
list 	 NN
list 	 VB
literature 	 NN
liter 	 NN
little 	 JJ
little 	 ADVB
little 	 DET
little 	 PRNOUN
live 	 JJ
live 	 ADVB
lively 	 JJ
live 	 VB
living 	 JJ
load 	 NN
load 	 VB
loan 	 NN
local 	 JJ
locally 	 ADVB
locate 	 VB
location 	 NN
lock 	 NN
lock 	 VB
logical 	 JJ
logic 	 NN
lonely 	 JJ
long 	 JJ
long 	 ADVB
look 	 NN
look 	 VB
loose 	 JJ
loosely 	 ADVB
lord 	 NN
lose 	 VB
loss 	 NN
lost 	 JJ
lot 	 ADVB
lot 	 DET
lot 	 PRNOUN
loud 	 JJ
loud 	 ADVB
loudly 	 ADVB
love 	 NN
lover 	 NN
love 	 VB
low 	 JJ
low 	 ADVB
lower 	 VB
loyal 	 JJ
luck 	 NN
lucky 	 JJ
lump 	 NN
lunch 	 NN
lung 	 NN
machine 	 NN
machinery 	 NN
mad 	 JJ
magazine 	 NN
magic 	 JJ
magic 	 NN
mail 	 NN
mail 	 VB
main 	 JJ
mainly 	 ADVB
maintain 	 VB
major 	 JJ
majority 	 NN
major 	 NN
make 	 NN
make-up 	 NN
make 	 VB
male 	 JJ
male 	 NN
mall 	 NN
management 	 NN
manager 	 NN
manage 	 VB
manner 	 NN
man 	 NN
manufacture 	 NN
manufacturer 	 NN
manufacture 	 VB
manufacturing 	 NN
many 	 DET
many 	 PRNOUN
map 	 NN
march 	 NN
March 	 NN
march 	 VB
marker 	 NN
marketing 	 NN
market 	 NN
mark 	 NN
mark 	 VB
marriage 	 NN
married 	 JJ
marry 	 VB
mass 	 JJ
massive 	 JJ
mass 	 NN
master 	 NN
matching 	 JJ
match 	 NN
match 	 VB
mate 	 NN
material 	 JJ
material 	 NN
mate 	 VB
mathematics 	 NN
math 	 NN
matter 	 NN
matter 	 VB
maximum 	 JJ
maximum 	 NN
maybe 	 ADVB
may 	 MODAL
May 	 NN
mayor 	 NN
meal 	 NN
meaning 	 NN
means 	 NN
mean 	 VB
meanwhile 	 ADVB
measurement 	 NN
measure 	 NN
measure 	 VB
meat 	 NN
media 	 NN
medicine 	 NN
medium 	 JJ
medium 	 NN
meeting 	 NN
meet 	 VB
melt 	 VB
member 	 NN
membership 	 NN
memory 	 NN
mental 	 JJ
mentally 	 ADVB
mention 	 VB
menu 	 NN
me 	 PRNOUN
mere 	 JJ
merely 	 ADVB
message 	 NN
mess 	 NN
mess 	 VB
messy 	 JJ
metal 	 NN
meter 	 NN
method 	 NN
middle 	 JJ
middle 	 NN
midnight 	 NN
might 	 MODAL
mild 	 JJ
mile 	 NN
military 	 JJ
milk 	 NN
milligram 	 NN
millimeter 	 NN
mind 	 NN
mind 	 VB
mine 	 NN
mine 	 PRNOUN
mineral 	 JJ
mineral 	 NN
minimum 	 JJ
minimum 	 NN
minister 	 NN
ministry 	 NN
minor 	 JJ
minority 	 NN
minute 	 NN
mirror 	 NN
missing 	 JJ
miss 	 NN
Miss 	 NN
miss 	 VB
mistaken 	 JJ
mistake 	 NN
mistake 	 VB
mixed 	 JJ
mix 	 NN
mixture 	 NN
mix 	 VB
mobile 	 JJ
model 	 NN
modern 	 JJ
moment 	 NN
mom 	 NN
Monday 	 NN
money 	 NN
monitor 	 NN
monitor 	 VB
month 	 NN
mood 	 NN
moon 	 NN
moral 	 JJ
morally 	 ADVB
more 	 ADVB
more 	 DET
moreover 	 ADVB
more 	 PRNOUN
morning 	 NN
most 	 ADVB
most 	 DET
mostly 	 ADVB
most 	 PRNOUN
mother 	 NN
motion 	 NN
motorcycle 	 NN
motor 	 NN
mountain 	 NN
mount 	 NN
mount 	 VB
mouse 	 NN
mouth 	 NN
movement 	 NN
move 	 NN
move 	 VB
movie 	 NN
moving 	 JJ
Mr. 	 ABBR
Mrs. 	 ABBR
Ms. 	 ABBR
much 	 ADVB
much 	 DET
much 	 PRNOUN
mud 	 NN
multiply 	 VB
murder 	 NN
murder 	 VB
muscle 	 NN
museum 	 NN
musical 	 JJ
musician 	 NN
music 	 NN
must 	 MODAL
my 	 DET
myself 	 PRNOUN
mysterious 	 JJ
mystery 	 NN
nail 	 NN
naked 	 JJ
name 	 NN
name 	 VB
narrow 	 JJ
national 	 JJ
nation 	 NN
native 	 JJ
natural 	 JJ
naturally 	 ADVB
nature 	 NN
navy 	 NN
near 	 JJ
near 	 ADVB
nearby 	 JJ
nearby 	 ADVB
nearly 	 ADVB
near 	 PREP
neat 	 JJ
neatly 	 ADVB
necessarily 	 ADVB
necessary 	 JJ
neck 	 NN
needle 	 NN
need 	 MODAL
need 	 NN
need 	 VB
negative 	 JJ
neighborhood 	 NN
neighbor 	 NN
neither 	 ADVB
neither 	 DET
neither 	 PRNOUN
nephew 	 NN
nerve 	 NN
nervous 	 JJ
nervously 	 ADVB
nest 	 NN
nest 	 VB
net 	 NN
network 	 NN
never 	 ADVB
nevertheless 	 ADVB
new 	 JJ
newly 	 ADVB
news 	 NN
newspaper 	 NN
next 	 JJ
next 	 ADVB
next 	 NN
nice 	 JJ
nicely 	 ADVB
niece 	 NN
night 	 NN
nobody 	 PRNOUN
no 	 DET
nod 	 VB
no 	 EXCLAM
noise 	 NN
noisily 	 ADVB
noisy 	 JJ
none 	 PRNOUN
nonsense 	 NN
noone 	 PRNOUN
nor 	 ADVB
nor 	 CONJ
normal 	 JJ
normally 	 ADVB
normal 	 NN
north 	 JJ
north 	 ADVB
northern 	 JJ
north 	 NN
nose 	 NN
not 	 ADVB
note 	 NN
note 	 VB
nothing 	 PRNOUN
noticeable 	 JJ
notice 	 NN
notice 	 VB
notion 	 NN
novel 	 NN
November 	 NN
now 	 ADVB
nowhere 	 ADVB
nuclear 	 JJ
number 	 NN
numerous 	 JJ
nurse 	 NN
nut 	 NN
obey 	 VB
objective 	 JJ
objective 	 NN
object 	 NN
object 	 VB
observation 	 NN
observe 	 VB
obtain 	 VB
obvious 	 JJ
obviously 	 ADVB
occasionally 	 ADVB
occasion 	 NN
occupied 	 JJ
occupy 	 VB
occur 	 VB
ocean 	 NN
oâ€™clock 	 ADVB
October 	 NN
odd 	 JJ
oddly 	 ADVB
off 	 ADVB
offend 	 VB
offense 	 NN
offensive 	 JJ
offer 	 NN
offer 	 VB
office 	 NN
officer 	 NN
official 	 JJ
officially 	 ADVB
official 	 NN
off 	 PREP
of 	 PREP
often 	 ADVB
oh 	 EXCLAM
oil 	 NN
OK 	 JJ
OK 	 ADVB
okay 	 JJ
okay 	 ADVB
okay 	 EXCLAM
OK 	 EXCLAM
old 	 JJ
old-fashioned 	 JJ
on 	 ADVB
once 	 ADVB
once 	 CONJ
one 	 DET
one 	 NUM
one 	 PRNOUN
onion 	 NN
online 	 JJ
online 	 ADVB
only 	 JJ
only 	 ADVB
on 	 PREP
onto 	 PREP
open 	 JJ
opening 	 NN
openly 	 ADVB
open 	 VB
operate 	 VB
operation 	 NN
opinion 	 NN
opponent 	 NN
opportunity 	 NN
oppose 	 VB
opposing 	 JJ
opposite 	 JJ
opposite 	 ADVB
opposite 	 NN
opposition 	 NN
option 	 NN
orange 	 JJ
orange 	 NN
or 	 CONJ
order 	 NN
order 	 VB
ordinary 	 JJ
organization 	 NN
organized 	 JJ
organize 	 VB
organ 	 NN
original 	 JJ
originally 	 ADVB
original 	 NN
origin 	 NN
other 	 JJ
other 	 PRNOUN
otherwise 	 ADVB
ought 	 MODAL
ounce 	 NN
our 	 DET
ourselves 	 PRNOUN
ours 	 PRNOUN
out 	 ADVB
outdoor 	 JJ
outdoors 	 ADVB
outer 	 JJ
outline 	 NN
outline 	 VB
out 	 PREP
output 	 NN
outside 	 JJ
outside 	 ADVB
outside 	 NN
outside 	 PREP
outstanding 	 JJ
oven 	 NN
over 	 ADVB
overall 	 JJ
overall 	 ADVB
overcome 	 VB
over 	 PREP
overseas 	 JJ
overseas 	 ADVB
owe 	 VB
own 	 JJ
owner 	 NN
own 	 PRNOUN
own 	 VB
pace 	 NN
package 	 NN
package 	 VB
pack 	 NN
pack 	 VB
page 	 NN
painful 	 JJ
pain 	 NN
painter 	 NN
painting 	 NN
paint 	 NN
paint 	 VB
pair 	 NN
palace 	 NN
pale 	 JJ
panel 	 NN
pan 	 NN
pants 	 NN
paper 	 NN
parallel 	 JJ
parent 	 NN
park 	 NN
park 	 VB
parliament 	 NN
participate 	 VB
particular 	 JJ
particularly 	 ADVB
partly 	 ADVB
partner 	 NN
partnership 	 NN
part 	 NN
party 	 NN
passage 	 NN
passenger 	 NN
passing 	 JJ
passing 	 NN
passion 	 NN
passport 	 NN
pass 	 VB
past 	 JJ
past 	 ADVB
past 	 NN
past 	 PREP
path 	 NN
patience 	 NN
patient 	 JJ
patient 	 NN
pattern 	 NN
pause 	 NN
pause 	 VB
payment 	 NN
pay 	 NN
pay 	 VB
peaceful 	 JJ
peace 	 NN
peak 	 NN
penalty 	 NN
pencil 	 NN
pen 	 NN
people 	 NN
pepper 	 NN
percent 	 JJ
percent 	 ADVB
percentage 	 NN
percent 	 NN
perfect 	 JJ
perfectly 	 ADVB
performance 	 NN
performer 	 NN
perform 	 VB
perhaps 	 ADVB
period 	 NN
permanent 	 JJ
permanently 	 ADVB
permission 	 NN
permit 	 VB
per 	 PREP
personal 	 JJ
personality 	 NN
personally 	 ADVB
person 	 NN
perspective 	 NN
persuade 	 VB
pet 	 NN
phase 	 NN
philosophy 	 NN
phone 	 NN
phone 	 VB
photocopy 	 NN
photocopy 	 VB
photographer 	 NN
photograph 	 NN
photograph 	 VB
photography 	 NN
photo 	 NN
phrase 	 NN
physical 	 JJ
physically 	 ADVB
physics 	 NN
piano 	 NN
pick 	 VB
picture 	 NN
piece 	 NN
pig 	 NN
pile 	 NN
pile 	 VB
pill 	 NN
pilot 	 NN
pink 	 JJ
pink 	 NN
pin 	 NN
pint 	 NN
pin 	 VB
pipe 	 NN
pitch 	 NN
pitch 	 VB
place 	 NN
place 	 VB
plain 	 JJ
plane 	 NN
planet 	 NN
planning 	 NN
plan 	 NN
plant 	 NN
plant 	 VB
plan 	 VB
plastic 	 JJ
plastic 	 NN
plate 	 NN
platform 	 NN
player 	 NN
play 	 NN
play 	 VB
pleasant 	 JJ
pleasantly 	 ADVB
pleased 	 JJ
please 	 EXCLAM
please 	 VB
pleasure 	 NN
plenty 	 ADVB
plenty 	 DET
plenty 	 NN
plenty 	 PRNOUN
plot 	 NN
plot 	 VB
plug 	 NN
plus 	 JJ
plus 	 CONJ
plus 	 NN
plus 	 PREP
p.m. 	 ABBR
pocket 	 NN
poem 	 NN
poetry 	 NN
pointed 	 JJ
point 	 NN
point 	 VB
poison 	 NN
poisonous 	 JJ
poison 	 VB
pole 	 NN
police 	 NN
policy 	 NN
polish 	 NN
polish 	 VB
polite 	 JJ
politely 	 ADVB
political 	 JJ
politically 	 ADVB
politician 	 NN
politics 	 NN
pollution 	 NN
pool 	 NN
poor 	 JJ
pop 	 NN
popular 	 JJ
population 	 NN
pop 	 VB
port 	 NN
pose 	 NN
pose 	 VB
position 	 NN
positive 	 JJ
possession 	 NN
possess 	 VB
possibility 	 NN
possible 	 JJ
possibly 	 ADVB
post 	 NN
post-office 	 NN
post 	 VB
potato 	 NN
potential 	 JJ
potentially 	 ADVB
potential 	 NN
pot 	 NN
pound 	 NN
pour 	 VB
poverty 	 NN
powder 	 NN
powerful 	 JJ
power 	 NN
practical 	 JJ
practically 	 ADVB
practice 	 NN
practice 	 VB
praise 	 NN
praise 	 VB
prayer 	 NN
precise 	 JJ
precisely 	 ADVB
predict 	 VB
preference 	 NN
prefer 	 VB
pregnant 	 JJ
premises 	 NN
preparation 	 NN
prepared 	 JJ
prepare 	 VB
presence 	 NN
present 	 JJ
presentation 	 NN
present 	 NN
present 	 VB
preserve 	 VB
president 	 NN
press 	 NN
pressure 	 NN
press 	 VB
presumably 	 ADVB
pretend 	 VB
pretty 	 JJ
pretty 	 ADVB
prevent 	 VB
previous 	 JJ
previously 	 ADVB
price 	 NN
pride 	 NN
priest 	 NN
primarily 	 ADVB
primary 	 JJ
prime-minister 	 NN
prince 	 NN
princess 	 NN
principal 	 JJ
principal 	 NN
principle 	 NN
printer 	 NN
print 	 NN
print 	 VB
prior 	 JJ
priority 	 NN
prisoner 	 NN
prison 	 NN
private 	 JJ
privately 	 ADVB
prize 	 NN
probably 	 ADVB
problem 	 NN
procedure 	 NN
proceed 	 VB
process 	 NN
process 	 VB
producer 	 NN
produce 	 VB
production 	 NN
product 	 NN
professional 	 JJ
professional 	 NN
profession 	 NN
professor 	 NN
profile 	 NN
profit 	 NN
program 	 NN
program 	 VB
progress 	 NN
progress 	 VB
project 	 NN
project 	 VB
promise 	 NN
promise 	 VB
promote 	 VB
promotion 	 NN
prompt 	 JJ
promptly 	 ADVB
prompt 	 VB
pronounce 	 VB
pronunciation 	 NN
proof 	 NN
proper 	 JJ
property 	 NN
proportion 	 NN
proposal 	 NN
propose 	 VB
prospect 	 NN
protection 	 NN
protect 	 VB
protest 	 NN
protest 	 VB
proud 	 JJ
proudly 	 ADVB
prove 	 VB
provided 	 CONJ
provide 	 VB
public 	 JJ
publication 	 NN
publicity 	 NN
publicly 	 ADVB
public 	 NN
publishing 	 NN
publish 	 VB
pull 	 NN
pull 	 VB
punch 	 NN
punch 	 VB
punishment 	 NN
punish 	 VB
purchase 	 NN
purchase 	 VB
pure 	 JJ
purely 	 ADVB
purple 	 JJ
purple 	 NN
purpose 	 NN
pursue 	 VB
push 	 NN
push 	 VB
put 	 VB
qualification 	 NN
qualified 	 JJ
qualify 	 VB
quality 	 NN
quantity 	 NN
quarter 	 NN
queen 	 NN
question 	 NN
question 	 VB
quick 	 JJ
quickly 	 ADVB
quiet 	 JJ
quietly 	 ADVB
quite 	 ADVB
quit 	 VB
quote 	 VB
race 	 NN
race 	 VB
racing 	 NN
radio 	 NN
rail 	 NN
railroad 	 NN
rain 	 NN
rain 	 VB
raise 	 VB
range 	 NN
rank 	 NN
rank 	 VB
rapid 	 JJ
rapidly 	 ADVB
rare 	 JJ
rarely 	 ADVB
rate 	 NN
rate 	 VB
rather 	 ADVB
raw 	 JJ
reach 	 VB
reaction 	 NN
react 	 VB
reader 	 NN
reading 	 NN
read 	 VB
ready 	 JJ
real 	 JJ
realistic 	 JJ
reality 	 NN
realize 	 VB
really 	 ADVB
rear 	 JJ
rear 	 NN
reasonable 	 JJ
reasonably 	 ADVB
reason 	 NN
recall 	 VB
receipt 	 NN
receive 	 VB
recent 	 JJ
recently 	 ADVB
reception 	 NN
recognition 	 NN
recognize 	 VB
recommendation 	 NN
recommend 	 VB
recording 	 NN
record 	 NN
record 	 VB
recover 	 VB
recovery 	 NN
red 	 JJ
red 	 NN
reduce 	 VB
reduction 	 NN
reference 	 NN
refer 	 VB
reflect 	 VB
reform 	 NN
reform 	 VB
refrigerator 	 NN
refusal 	 NN
refuse 	 VB
regarding 	 PREP
regard 	 NN
regard 	 VB
regional 	 JJ
region 	 NN
register 	 NN
register 	 VB
regret 	 NN
regret 	 VB
regular 	 JJ
regularly 	 ADVB
regulation 	 NN
reject 	 VB
related 	 JJ
relate 	 VB
relation 	 NN
relationship 	 NN
relative 	 JJ
relatively 	 ADVB
relative 	 NN
relaxed 	 JJ
relaxing 	 JJ
relax 	 VB
release 	 NN
release 	 VB
relevant 	 JJ
relief 	 NN
religion 	 NN
religious 	 JJ
rely 	 VB
remaining 	 JJ
remains 	 NN
remain 	 VB
remarkable 	 JJ
remarkably 	 ADVB
remark 	 NN
remark 	 VB
remember 	 VB
remind 	 VB
remote 	 JJ
removal 	 NN
remove 	 VB
rent 	 NN
rent 	 VB
repair 	 NN
repair 	 VB
repeated 	 JJ
repeatedly 	 ADVB
repeat 	 VB
replace 	 VB
reply 	 NN
reply 	 VB
reporter 	 NN
report 	 NN
report 	 VB
representative 	 JJ
representative 	 NN
represent 	 VB
reproduce 	 VB
reputation 	 NN
request 	 NN
request 	 VB
requirement 	 NN
require 	 VB
rescue 	 NN
rescue 	 VB
research 	 NN
research 	 VB
reservation 	 NN
reserve 	 NN
reserve 	 VB
resident 	 JJ
resident 	 NN
resistance 	 NN
resist 	 VB
resolve 	 VB
resort 	 NN
resource 	 NN
respect 	 NN
respect 	 VB
respond 	 VB
response 	 NN
responsibility 	 NN
responsible 	 JJ
restaurant 	 NN
rest 	 NN
restore 	 VB
restricted 	 JJ
restriction 	 NN
restrict 	 VB
rest 	 VB
result 	 NN
result 	 VB
retain 	 VB
retired 	 JJ
retirement 	 NN
retire 	 VB
return 	 NN
return 	 VB
reveal 	 VB
reverse 	 NN
reverse 	 VB
review 	 NN
review 	 VB
revise 	 VB
revision 	 NN
revolution 	 NN
reward 	 NN
reward 	 VB
rhythm 	 NN
rice 	 NN
rich 	 JJ
ride 	 NN
rider 	 NN
ride 	 VB
ridiculous 	 JJ
riding 	 NN
rid 	 VB
right 	 JJ
right 	 ADVB
rightly 	 ADVB
right 	 NN
ring 	 NN
ring 	 VB
rise 	 NN
rise 	 VB
risk 	 NN
risk 	 VB
rival 	 JJ
rival 	 NN
river 	 NN
road 	 NN
rob 	 VB
rock 	 NN
role 	 NN
roll 	 NN
roll 	 VB
romantic 	 JJ
roof 	 NN
room 	 NN
root 	 NN
rope 	 NN
rose 	 NN
rough 	 JJ
roughly 	 ADVB
round 	 JJ
round 	 NN
route 	 NN
routine 	 JJ
routine 	 NN
row 	 NN
royal 	 JJ
rubber 	 NN
rub 	 VB
rude 	 JJ
rudely 	 ADVB
ruined 	 JJ
ruin 	 NN
ruin 	 VB
rule 	 NN
ruler 	 NN
rule 	 VB
rumor 	 NN
runner 	 NN
running 	 NN
run 	 NN
run 	 VB
rural 	 JJ
rush 	 NN
rush 	 VB
sack 	 NN
sad 	 JJ
sadly 	 ADVB
sadness 	 NN
safe 	 JJ
safely 	 ADVB
safety 	 NN
sailing 	 NN
sail 	 NN
sailor 	 NN
sail 	 VB
salad 	 NN
salary 	 NN
sale 	 NN
salt 	 NN
salty 	 JJ
same 	 JJ
same 	 PRNOUN
sample 	 NN
sand 	 NN
satisfaction 	 NN
satisfied 	 JJ
satisfying 	 JJ
satisfy 	 VB
Saturday 	 NN
sauce 	 NN
save 	 VB
saving 	 NN
say 	 VB
scale 	 NN
scared 	 JJ
scare 	 NN
scare 	 VB
scary 	 JJ
scene 	 NN
schedule 	 NN
schedule 	 VB
school 	 NN
science 	 NN
scientific 	 JJ
scientist 	 NN
scissors 	 NN
score 	 NN
score 	 VB
scratch 	 NN
scratch 	 VB
scream 	 NN
scream 	 VB
screen 	 NN
screw 	 NN
screw 	 VB
seal 	 NN
seal 	 VB
sea 	 NN
search 	 NN
search 	 VB
season 	 NN
seat 	 NN
second 	 ADVB
secondary 	 JJ
second 	 DET
second 	 NN
second 	 ORD
secret 	 JJ
secretary 	 NN
secretly 	 ADVB
secret 	 NN
section 	 NN
sector 	 NN
secure 	 JJ
secure 	 VB
security 	 NN
seed 	 NN
seek 	 VB
seem 	 LINK_VB
see 	 VB
selection 	 NN
select 	 VB
self 	 NN
sell 	 VB
semester 	 NN
senate 	 NN
senator 	 NN
send 	 VB
senior 	 JJ
senior 	 NN
sense 	 NN
sensible 	 JJ
sensitive 	 JJ
sentence 	 NN
separate 	 JJ
separated 	 JJ
separately 	 ADVB
separate 	 VB
separation 	 NN
September 	 NN
series 	 NN
serious 	 JJ
seriously 	 ADVB
servant 	 NN
serve 	 VB
service 	 NN
session 	 NN
set 	 NN
settle 	 VB
set 	 VB
several 	 DET
several 	 PRNOUN
severe 	 JJ
severely 	 ADVB
sew 	 VB
sex 	 NN
sexual 	 JJ
sexually 	 ADVB
shade 	 NN
shadow 	 NN
shake 	 NN
shake 	 VB
shall 	 MODAL
shallow 	 JJ
shame 	 NN
shaped 	 JJ
shape 	 NN
shape 	 VB
share 	 NN
share 	 VB
sharp 	 JJ
sharply 	 ADVB
shave 	 VB
sheep 	 NN
sheet 	 NN
shelf 	 NN
shell 	 NN
shelter 	 NN
shelter 	 VB
she 	 PRNOUN
shift 	 NN
shift 	 VB
shine 	 VB
shiny 	 JJ
ship 	 NN
shirt 	 NN
shocked 	 JJ
shocking 	 JJ
shock 	 NN
shock 	 VB
shoe 	 NN
shooting 	 NN
shoot 	 VB
shop 	 NN
shopping 	 NN
shop 	 VB
short 	 JJ
shortly 	 ADVB
shot 	 NN
shoulder 	 NN
should 	 MODAL
shout 	 NN
shout 	 VB
shower 	 NN
show 	 NN
show 	 VB
shut 	 VB
shy 	 JJ
sick 	 JJ
side 	 NN
sideways 	 JJ
sideways 	 ADVB
sight 	 NN
signal 	 NN
signal 	 VB
signature 	 NN
significant 	 JJ
significantly 	 ADVB
sign 	 NN
sign 	 VB
silence 	 NN
silent 	 JJ
silk 	 NN
silly 	 JJ
silver 	 JJ
silver 	 NN
similar 	 JJ
similarly 	 ADVB
simple 	 JJ
simply 	 ADVB
since 	 ADVB
since 	 CONJ
since 	 PREP
sincere 	 JJ
sincerely 	 ADVB
singer 	 NN
singing 	 NN
single 	 JJ
sing 	 VB
sink 	 VB
sir 	 NN
sister 	 NN
site 	 NN
situation 	 NN
sit 	 VB
size 	 NN
skilled 	 JJ
skillful 	 JJ
skillfully 	 ADVB
skill 	 NN
skin 	 NN
skirt 	 NN
sky 	 NN
sleep 	 NN
sleep 	 VB
sleeve 	 NN
slice 	 NN
slice 	 VB
slide 	 VB
slight 	 JJ
slightly 	 ADVB
slip 	 VB
slope 	 NN
slope 	 VB
slow 	 JJ
slowly 	 ADVB
small 	 JJ
smart 	 JJ
smash 	 NN
smash 	 VB
smell 	 NN
smell 	 VB
smile 	 NN
smile 	 VB
smoke 	 NN
smoke 	 VB
smoking 	 NN
smooth 	 JJ
smoothly 	 ADVB
snake 	 NN
snow 	 NN
snow 	 VB
so 	 ADVB
soap 	 NN
social 	 JJ
socially 	 ADVB
society 	 NN
sock 	 NN
so 	 CONJ
soft 	 JJ
softly 	 ADVB
software 	 NN
soil 	 NN
soldier 	 NN
solid 	 JJ
solid 	 NN
solution 	 NN
solve 	 VB
somebody 	 PRNOUN
some 	 DET
somehow 	 ADVB
someone 	 PRNOUN
some 	 PRNOUN
something 	 PRNOUN
sometimes 	 ADVB
somewhat 	 ADVB
somewhere 	 ADVB
song 	 NN
son 	 NN
soon 	 ADVB
sore 	 JJ
sorry 	 JJ
sorry 	 EXCLAM
sort 	 NN
sort 	 VB
soul 	 NN
sound 	 NN
sound 	 VB
soup 	 NN
sour 	 JJ
source 	 NN
south 	 JJ
south 	 ADVB
southern 	 JJ
south 	 NN
space 	 NN
spare 	 JJ
speaker 	 NN
speak 	 VB
special 	 JJ
specialist 	 NN
specially 	 ADVB
species 	 NN
specific 	 JJ
specifically 	 ADVB
speech 	 NN
speed 	 NN
spelling 	 NN
spell 	 NN
spell 	 VB
spend 	 VB
spice 	 NN
spicy 	 JJ
spider 	 NN
spill 	 VB
spin 	 VB
spirit 	 NN
spiritual 	 JJ
spite 	 NN
split 	 NN
split 	 VB
spoil 	 VB
spoken 	 JJ
spoon 	 NN
sport 	 NN
spot 	 NN
spray 	 NN
spray 	 VB
spread 	 VB
spring 	 NN
square 	 JJ
square 	 NN
squeeze 	 NN
squeeze 	 VB
stable 	 JJ
stable 	 NN
staff 	 NN
stage 	 NN
stair 	 NN
stamp 	 NN
stamp 	 VB
standard 	 JJ
standard 	 NN
stand 	 NN
stand 	 VB
stare 	 NN
stare 	 VB
star 	 NN
start 	 NN
start 	 VB
star 	 VB
state 	 JJ
statement 	 NN
state 	 NN
state 	 VB
station 	 NN
statue 	 NN
status 	 NN
stay 	 NN
stay 	 VB
steadily 	 ADVB
steady 	 JJ
steal 	 VB
steam 	 NN
steel 	 NN
steep 	 JJ
steeply 	 ADVB
steer 	 VB
step 	 NN
step 	 VB
stick 	 NN
stick 	 VB
sticky 	 JJ
stiff 	 JJ
still 	 JJ
still 	 ADVB
sting 	 NN
sting 	 VB
stir 	 VB
stock 	 NN
stomach 	 NN
stone 	 NN
stop 	 NN
stop 	 VB
store 	 NN
store 	 VB
storm 	 NN
story 	 NN
stove 	 NN
straight 	 JJ
straight 	 ADVB
strain 	 NN
strange 	 JJ
strangely 	 ADVB
stranger 	 NN
strategy 	 NN
stream 	 NN
street 	 NN
strength 	 NN
stressed 	 JJ
stress 	 NN
stress 	 VB
stretch 	 VB
strict 	 JJ
strictly 	 ADVB
strike 	 NN
strike 	 VB
striking 	 JJ
string 	 NN
striped 	 JJ
stripe 	 NN
strip 	 NN
strip 	 VB
stroke 	 NN
stroke 	 VB
strong 	 JJ
strongly 	 ADVB
structure 	 NN
struggle 	 NN
struggle 	 VB
student 	 NN
studio 	 NN
study 	 NN
study 	 VB
stuff 	 NN
stupid 	 JJ
style 	 NN
subject 	 NN
substance 	 NN
substantial 	 JJ
substantially 	 ADVB
substitute 	 NN
substitute 	 VB
succeed 	 VB
successful 	 JJ
successfully 	 ADVB
success 	 NN
such 	 DET
such 	 PRNOUN
suck 	 VB
sudden 	 JJ
suddenly 	 ADVB
suffering 	 NN
suffer 	 VB
sufficient 	 JJ
sufficiently 	 ADVB
sugar 	 NN
suggestion 	 NN
suggest 	 VB
suitable 	 JJ
suit 	 NN
suit 	 VB
summary 	 NN
summer 	 NN
sum 	 NN
Sunday 	 NN
sun 	 NN
superior 	 JJ
supermarket 	 NN
supply 	 NN
supply 	 VB
supporter 	 NN
support 	 NN
support 	 VB
suppose 	 VB
sure 	 JJ
sure 	 ADVB
surely 	 ADVB
surface 	 NN
surgery 	 NN
surprised 	 JJ
surprise 	 NN
surprise 	 VB
surprising 	 JJ
surprisingly 	 ADVB
surrounding 	 JJ
surroundings 	 NN
surround 	 VB
survey 	 NN
survey 	 VB
survive 	 VB
suspect 	 NN
suspect 	 VB
suspicion 	 NN
suspicious 	 JJ
swallow 	 VB
swear 	 VB
sweater 	 NN
sweat 	 NN
sweat 	 VB
sweep 	 VB
sweet 	 JJ
sweet 	 NN
swelling 	 NN
swell 	 VB
swimming 	 NN
swim 	 VB
swing 	 NN
swing 	 VB
switch 	 NN
switch 	 VB
swollen 	 JJ
symbol 	 NN
sympathetic 	 JJ
sympathy 	 NN
system 	 NN
table 	 NN
tablet 	 NN
tackle 	 NN
tackle 	 VB
tail 	 NN
take 	 VB
tale 	 NN
talent 	 NN
talk 	 NN
talk 	 VB
tall 	 JJ
tank 	 NN
tape 	 NN
tap 	 NN
tap 	 VB
target 	 NN
task 	 NN
taste 	 NN
taste 	 VB
taxi 	 NN
tax 	 NN
tax 	 VB
teacher 	 NN
teaching 	 NN
teach 	 VB
team 	 NN
tea 	 NN
tear 	 NN
tear 	 VB
technical 	 JJ
technique 	 NN
technology 	 NN
television 	 NN
tell 	 VB
temperature 	 NN
temporarily 	 ADVB
temporary 	 JJ
tendency 	 NN
tend 	 VB
tension 	 NN
tent 	 NN
term 	 NN
terrible 	 JJ
terribly 	 ADVB
territory 	 NN
terrorism 	 NN
terrorist 	 NN
terror 	 NN
test 	 NN
test 	 VB
text 	 NN
than 	 CONJ
thanks 	 EXCLAM
thanks 	 NN
thank 	 VB
than 	 PREP
theater 	 NN
the 	 DEFART
their 	 DET
theirs 	 PRNOUN
theme 	 NN
them 	 PRNOUN
themselves 	 PRNOUN
then 	 ADVB
theory 	 NN
there 	 ADVB
therefore 	 ADVB
they 	 PRNOUN
thick 	 JJ
thickly 	 ADVB
thickness 	 NN
thief 	 NN
thin 	 JJ
thing 	 NN
thinking 	 NN
think 	 VB
thirsty 	 JJ
this 	 DET
this 	 PRNOUN
thorough 	 JJ
thoroughly 	 ADVB
though 	 ADVB
though 	 CONJ
thought 	 NN
thread 	 NN
threatening 	 JJ
threaten 	 VB
threat 	 NN
throat 	 NN
through 	 ADVB
throughout 	 ADVB
throughout 	 PREP
through 	 PREP
throw 	 VB
thumb 	 NN
Thursday 	 NN
thus 	 ADVB
ticket 	 NN
tie 	 NN
tie 	 VB
tight 	 JJ
tight 	 ADVB
tightly 	 ADVB
till 	 CONJ
till 	 PREP
time 	 NN
timetable 	 NN
tin 	 NN
tiny 	 JJ
tip 	 NN
tip 	 VB
tired 	 JJ
tire 	 NN
tire 	 VB
tiring 	 JJ
title 	 NN
today 	 ADVB
today 	 NN
toe 	 NN
together 	 ADVB
toilet 	 NN
to 	 INF
tomato 	 NN
tomorrow 	 ADVB
tomorrow 	 NN
tone 	 NN
tongue 	 NN
tonight 	 ADVB
tonight 	 NN
ton 	 NN
too 	 ADVB
tool 	 NN
tooth 	 NN
top 	 JJ
topic 	 NN
top 	 NN
to 	 PREP
total 	 JJ
totally 	 ADVB
total 	 NN
touch 	 NN
touch 	 VB
tough 	 JJ
tourist 	 NN
tour 	 NN
tour 	 VB
toward 	 PREP
towards 	 PREP
towel 	 NN
tower 	 NN
town 	 NN
toy 	 JJ
toy 	 NN
trace 	 NN
trace 	 VB
track 	 NN
trade 	 NN
trade 	 VB
traditional 	 JJ
traditionally 	 ADVB
tradition 	 NN
traffic 	 NN
training 	 NN
train 	 NN
train 	 VB
transfer 	 NN
transfer 	 VB
transform 	 VB
transition 	 NN
translate 	 VB
translation 	 NN
transparent 	 JJ
transportation 	 NN
transport 	 NN
transport 	 VB
trap 	 NN
trap 	 VB
trash 	 NN
traveler 	 NN
travel 	 NN
travel 	 VB
treatment 	 NN
treat 	 VB
tree 	 NN
trend 	 NN
trial 	 NN
triangle 	 NN
trick 	 NN
trick 	 VB
trip 	 NN
trip 	 VB
troop 	 NN
tropical 	 JJ
trouble 	 NN
truck 	 NN
true 	 JJ
truly 	 ADVB
trust 	 NN
trust 	 VB
truth 	 NN
try 	 VB
tube 	 NN
Tuesday 	 NN
tune 	 NN
tune 	 VB
tunnel 	 NN
turn 	 NN
turn 	 VB
TV 	 NN
twice 	 ADVB
twin 	 JJ
twin 	 NN
twisted 	 JJ
twist 	 NN
twist 	 VB
type 	 NN
type 	 VB
typical 	 JJ
typically 	 ADVB
ugly 	 JJ
ultimate 	 JJ
ultimately 	 ADVB
umbrella 	 NN
unable 	 JJ
unacceptable 	 JJ
uncertain 	 JJ
uncle 	 NN
uncomfortable 	 JJ
unconscious 	 JJ
uncontrolled 	 JJ
under 	 ADVB
underground 	 JJ
underground 	 ADVB
underneath 	 ADVB
underneath 	 PREP
under 	 PREP
understanding 	 NN
understand 	 VB
underwater 	 JJ
underwater 	 ADVB
underwear 	 NN
undo 	 VB
unemployed 	 JJ
unemployment 	 NN
unexpected 	 JJ
unexpectedly 	 ADVB
unfair 	 JJ
unfairly 	 ADVB
unfortunate 	 JJ
unfortunately 	 ADVB
unfriendly 	 JJ
unhappiness 	 NN
unhappy 	 JJ
uniform 	 JJ
uniform 	 NN
unimportant 	 JJ
union 	 NN
unique 	 JJ
united 	 JJ
unite 	 VB
unit 	 NN
universal 	 JJ
universe 	 NN
university 	 NN
unkind 	 JJ
unknown 	 JJ
unless 	 CONJ
unlike 	 JJ
unlikely 	 JJ
unlike 	 PREP
unload 	 VB
unlucky 	 JJ
unnecessary 	 JJ
unpleasant 	 JJ
unreasonable 	 JJ
unsteady 	 JJ
unsuccessful 	 ADVB
until 	 CONJ
until 	 PREP
unusual 	 JJ
unusually 	 ADVB
unwilling 	 JJ
unwillingly 	 ADVB
up 	 ADVB
upon 	 PREP
upper 	 JJ
up 	 PREP
upset 	 JJ
upset 	 VB
upside 	 ADVB
upstairs 	 JJ
upstairs 	 ADVB
upstairs 	 NN
upward 	 JJ
upward 	 ADVB
upwards 	 ADVB
urban 	 JJ
urge 	 NN
urgent 	 JJ
urge 	 VB
used 	 JJ
useful 	 JJ
useless 	 JJ
use 	 NN
user 	 NN
use 	 VB
us 	 PRNOUN
usual 	 JJ
usually 	 ADVB
vacation 	 NN
valid 	 JJ
valley 	 NN
valuable 	 JJ
value 	 NN
value 	 VB
van 	 NN
variation 	 NN
varied 	 JJ
variety 	 NN
various 	 JJ
vary 	 VB
vast 	 JJ
vegetable 	 NN
vehicle 	 NN
venture 	 NN
version 	 NN
vertical 	 JJ
very 	 ADVB
via 	 PREP
victim 	 NN
victory 	 NN
video 	 NN
view 	 NN
view 	 VB
violence 	 NN
violent 	 JJ
violently 	 ADVB
virtually 	 ADVB
virus 	 NN
visible 	 JJ
vision 	 NN
visit 	 NN
visitor 	 NN
visit 	 VB
vital 	 JJ
vmedical 	 JJ
vocabulary 	 NN
voice 	 NN
volume 	 NN
vote 	 NN
vote 	 VB
wage 	 NN
waist 	 NN
waiter 	 NN
waitress 	 NN
wait 	 VB
wake 	 VB
walking 	 NN
walk 	 NN
walk 	 VB
wallet 	 NN
wall 	 NN
wander 	 NN
wander 	 VB
want 	 VB
warm 	 JJ
warmth 	 NN
warm 	 VB
warning 	 NN
war 	 NN
warn 	 VB
wash 	 VB
waste 	 JJ
waste 	 NN
waste 	 VB
watch 	 NN
watch 	 VB
water 	 NN
wave 	 NN
wave 	 VB
way 	 NN
weak 	 JJ
weakness 	 NN
wealth 	 NN
weapon 	 NN
wear 	 VB
weather 	 NN
web 	 NN
Web 	 NN
website 	 NN
wedding 	 NN
Wednesday 	 NN
weekend 	 NN
weekly 	 JJ
week 	 NN
weight 	 NN
weigh 	 VB
weird 	 JJ
welcome 	 JJ
welcome 	 EXCLAM
welcome 	 NN
welcome 	 VB
well 	 JJ
well 	 ADVB
well 	 EXCLAM
we 	 PRNOUN
west 	 JJ
west 	 ADVB
western 	 JJ
west 	 NN
wet 	 JJ
what 	 DET
whatever 	 DET
whatever 	 PRNOUN
what 	 PRNOUN
wheel 	 NN
when 	 ADVB
when 	 CONJ
whenever 	 CONJ
when 	 PRNOUN
where 	 ADVB
whereas 	 CONJ
where 	 CONJ
wherever 	 CONJ
whether 	 CONJ
which 	 DET
which 	 PRNOUN
while 	 CONJ
while 	 NN
whisper 	 NN
whisper 	 VB
whistle 	 NN
whistle 	 VB
white 	 JJ
white 	 NN
whoever 	 PRNOUN
whole 	 JJ
whole 	 NN
whom 	 PRNOUN
who 	 PRNOUN
whose 	 DET
whose 	 PRNOUN
why 	 ADVB
wide 	 JJ
widely 	 ADVB
width 	 NN
wife 	 NN
wild 	 JJ
wildly 	 ADVB
willing 	 JJ
willing 	 ADVB
willingly 	 ADVB
willingness 	 NN
will 	 MODAL
will 	 NN
wind 	 NN
window 	 NN
wind 	 VB
wine 	 NN
wing 	 NN
winner 	 NN
winning 	 JJ
winter 	 NN
win 	 VB
wire 	 NN
wise 	 JJ
wish 	 NN
wish 	 VB
withdraw 	 VB
within 	 PREP
without 	 PREP
with 	 PREP
witness 	 NN
witness 	 VB
woman 	 NN
wonderful 	 JJ
wonder 	 VB
wooden 	 JJ
wood 	 NN
wool 	 NN
word 	 NN
worker 	 NN
working 	 JJ
work 	 NN
work 	 VB
world 	 NN
worried 	 JJ
worrying 	 JJ
worry 	 NN
worry 	 VB
worship 	 NN
worship 	 VB
worth 	 JJ
would 	 MODAL
wounded 	 JJ
wound 	 NN
wound 	 VB
wrap 	 VB
wrist 	 NN
writer 	 NN
write 	 VB
writing 	 NN
written 	 JJ
wrong 	 JJ
wrong 	 ADVB
wrongly 	 ADVB
yard 	 NN
yawn 	 NN
yawn 	 VB
yeah 	 EXCLAM
year 	 NN
yellow 	 JJ
yellow 	 NN
yes 	 EXCLAM
yes 	 NN
yesterday 	 ADVB
yesterday 	 NN
yet 	 ADVB
yet 	 CONJ
young 	 JJ
you 	 PRNOUN
your 	 DET
yourself 	 PRNOUN
yours 	 PRNOUN
youth 	 NN
zero 	 NUM
zone 	 NN
